Mes,Departamento de residencia,Total,Hombres,Mujeres,Anio
Todos los meses,Todos los departamentos,351628,178863,172765,09
Todos los meses,Guatemala,58906,29884,29022,09
Todos los meses,El Progreso,3814,1949,1865,09
Todos los meses,Sacatepéquez,6708,3435,3273,09
Todos los meses,Chimaltenango,14482,7413,7069,09
Todos los meses,Escuintla,14552,7455,7097,09
Todos los meses,Santa Rosa,8181,4165,4016,09
Todos los meses,Sololá,9511,4838,4673,09
Todos los meses,Totonicapán,11410,5792,5618,09
Todos los meses,Quetzaltenango,18653,9391,9262,09
Todos los meses,Suchitepéquez,12771,6543,6228,09
Todos los meses,Retalhuleu,7297,3756,3541,09
Todos los meses,San Marcos,27590,14054,13536,09
Todos los meses,Huehuetenango,32782,16552,16230,09
Todos los meses,Quiché,26849,13694,13155,09
Todos los meses,Baja Verapaz,7218,3646,3572,09
Todos los meses,Alta Verapaz,32925,16597,16328,09
Todos los meses,Petén,13632,6937,6695,09
Todos los meses,Izabal,8956,4564,4392,09
Todos los meses,Zacapa,5626,2901,2725,09
Todos los meses,Chiquimula,10181,5256,4925,09
Todos los meses,Jalapa,8270,4206,4064,09
Todos los meses,Jutiapa,10809,5565,5244,09
Todos los meses,Extranjero,129,75,54,09
Todos los meses,Ignorado,376,195,181,09
Enero,Todos los departamentos,30715,15566,15149,09
Enero,Guatemala,5189,2605,2584,09
Enero,El Progreso,305,158,147,09
Enero,Sacatepéquez,601,312,289,09
Enero,Chimaltenango,1211,612,599,09
Enero,Escuintla,1217,645,572,09
Enero,Santa Rosa,714,353,361,09
Enero,Sololá,847,422,425,09
Enero,Totonicapán,1028,543,485,09
Enero,Quetzaltenango,1545,780,765,09
Enero,Suchitepéquez,1052,542,510,09
Enero,Retalhuleu,621,336,285,09
Enero,San Marcos,2410,1182,1228,09
Enero,Huehuetenango,2915,1465,1450,09
Enero,Quiché,2447,1231,1216,09
Enero,Baja Verapaz,617,308,309,09
Enero,Alta Verapaz,3028,1499,1529,09
Enero,Petén,1097,575,522,09
Enero,Izabal,632,318,314,09
Enero,Zacapa,495,259,236,09
Enero,Chiquimula,952,494,458,09
Enero,Jalapa,822,420,402,09
Enero,Jutiapa,934,485,449,09
Enero,Extranjero,18,9,9,09
Enero,Ignorado,18,13,5,09
Febrero,Todos los departamentos,26078,13383,12695,09
Febrero,Guatemala,4506,2318,2188,09
Febrero,El Progreso,267,128,139,09
Febrero,Sacatepéquez,503,261,242,09
Febrero,Chimaltenango,1116,591,525,09
Febrero,Escuintla,1096,564,532,09
Febrero,Santa Rosa,610,326,284,09
Febrero,Sololá,751,398,353,09
Febrero,Totonicapán,832,428,404,09
Febrero,Quetzaltenango,1430,728,702,09
Febrero,Suchitepéquez,897,465,432,09
Febrero,Retalhuleu,538,292,246,09
Febrero,San Marcos,2006,1030,976,09
Febrero,Huehuetenango,2434,1233,1201,09
Febrero,Quiché,2107,1085,1022,09
Febrero,Baja Verapaz,532,267,265,09
Febrero,Alta Verapaz,2301,1151,1150,09
Febrero,Petén,915,445,470,09
Febrero,Izabal,553,299,254,09
Febrero,Zacapa,409,211,198,09
Febrero,Chiquimula,789,390,399,09
Febrero,Jalapa,634,317,317,09
Febrero,Jutiapa,818,437,381,09
Febrero,Extranjero,13,6,7,09
Febrero,Ignorado,21,13,8,09
Marzo,Todos los departamentos,29319,14861,14458,09
Marzo,Guatemala,5200,2604,2596,09
Marzo,El Progreso,354,193,161,09
Marzo,Sacatepéquez,592,305,287,09
Marzo,Chimaltenango,1251,670,581,09
Marzo,Escuintla,1195,604,591,09
Marzo,Santa Rosa,638,351,287,09
Marzo,Sololá,778,376,402,09
Marzo,Totonicapán,958,470,488,09
Marzo,Quetzaltenango,1537,752,785,09
Marzo,Suchitepéquez,1087,541,546,09
Marzo,Retalhuleu,612,309,303,09
Marzo,San Marcos,2351,1209,1142,09
Marzo,Huehuetenango,2695,1327,1368,09
Marzo,Quiché,2292,1179,1113,09
Marzo,Baja Verapaz,640,315,325,09
Marzo,Alta Verapaz,2613,1291,1322,09
Marzo,Petén,1130,613,517,09
Marzo,Izabal,607,320,287,09
Marzo,Zacapa,421,236,185,09
Marzo,Chiquimula,783,402,381,09
Marzo,Jalapa,673,329,344,09
Marzo,Jutiapa,885,453,432,09
Marzo,Extranjero,6,4,2,09
Marzo,Ignorado,21,8,13,09
Abril,Todos los departamentos,27917,14111,13806,09
Abril,Guatemala,4847,2469,2378,09
Abril,El Progreso,319,159,160,09
Abril,Sacatepéquez,522,266,256,09
Abril,Chimaltenango,1142,554,588,09
Abril,Escuintla,1244,646,598,09
Abril,Santa Rosa,649,322,327,09
Abril,Sololá,757,365,392,09
Abril,Totonicapán,962,494,468,09
Abril,Quetzaltenango,1596,801,795,09
Abril,Suchitepéquez,1029,513,516,09
Abril,Retalhuleu,563,292,271,09
Abril,San Marcos,2222,1120,1102,09
Abril,Huehuetenango,2575,1294,1281,09
Abril,Quiché,2183,1109,1074,09
Abril,Baja Verapaz,545,270,275,09
Abril,Alta Verapaz,2511,1284,1227,09
Abril,Petén,1050,527,523,09
Abril,Izabal,547,277,270,09
Abril,Zacapa,419,194,225,09
Abril,Chiquimula,739,391,348,09
Abril,Jalapa,641,330,311,09
Abril,Jutiapa,825,419,406,09
Abril,Extranjero,8,3,5,09
Abril,Ignorado,22,12,10,09
Mayo,Todos los departamentos,29363,15020,14343,09
Mayo,Guatemala,4963,2497,2466,09
Mayo,El Progreso,305,144,161,09
Mayo,Sacatepéquez,572,295,277,09
Mayo,Chimaltenango,1172,607,565,09
Mayo,Escuintla,1204,629,575,09
Mayo,Santa Rosa,723,386,337,09
Mayo,Sololá,821,414,407,09
Mayo,Totonicapán,991,504,487,09
Mayo,Quetzaltenango,1587,798,789,09
Mayo,Suchitepéquez,1069,546,523,09
Mayo,Retalhuleu,606,302,304,09
Mayo,San Marcos,2378,1211,1167,09
Mayo,Huehuetenango,2655,1373,1282,09
Mayo,Quiché,2264,1143,1121,09
Mayo,Baja Verapaz,590,306,284,09
Mayo,Alta Verapaz,2636,1356,1280,09
Mayo,Petén,1096,565,531,09
Mayo,Izabal,713,373,340,09
Mayo,Zacapa,451,234,217,09
Mayo,Chiquimula,915,480,435,09
Mayo,Jalapa,721,366,355,09
Mayo,Jutiapa,902,473,429,09
Mayo,Extranjero,6,5,1,09
Mayo,Ignorado,23,13,10,09
Junio,Todos los departamentos,27988,14184,13804,09
Junio,Guatemala,4846,2503,2343,09
Junio,El Progreso,296,147,149,09
Junio,Sacatepéquez,553,266,287,09
Junio,Chimaltenango,1161,608,553,09
Junio,Escuintla,1151,588,563,09
Junio,Santa Rosa,653,310,343,09
Junio,Sololá,760,391,369,09
Junio,Totonicapán,935,461,474,09
Junio,Quetzaltenango,1511,730,781,09
Junio,Suchitepéquez,1054,571,483,09
Junio,Retalhuleu,582,302,280,09
Junio,San Marcos,2207,1137,1070,09
Junio,Huehuetenango,2587,1289,1298,09
Junio,Quiché,2124,1083,1041,09
Junio,Baja Verapaz,566,267,299,09
Junio,Alta Verapaz,2551,1250,1301,09
Junio,Petén,1010,529,481,09
Junio,Izabal,695,356,339,09
Junio,Zacapa,431,214,217,09
Junio,Chiquimula,818,425,393,09
Junio,Jalapa,636,317,319,09
Junio,Jutiapa,822,416,406,09
Junio,Extranjero,7,4,3,09
Junio,Ignorado,32,20,12,09
Julio,Todos los departamentos,29476,15078,14398,09
Julio,Guatemala,5046,2587,2459,09
Julio,El Progreso,343,174,169,09
Julio,Sacatepéquez,577,293,284,09
Julio,Chimaltenango,1220,631,589,09
Julio,Escuintla,1228,638,590,09
Julio,Santa Rosa,679,354,325,09
Julio,Sololá,764,418,346,09
Julio,Totonicapán,973,506,467,09
Julio,Quetzaltenango,1516,748,768,09
Julio,Suchitepéquez,1044,520,524,09
Julio,Retalhuleu,607,321,286,09
Julio,San Marcos,2264,1165,1099,09
Julio,Huehuetenango,2744,1391,1353,09
Julio,Quiché,2312,1179,1133,09
Julio,Baja Verapaz,622,324,298,09
Julio,Alta Verapaz,2851,1439,1412,09
Julio,Petén,1100,536,564,09
Julio,Izabal,779,393,386,09
Julio,Zacapa,474,257,217,09
Julio,Chiquimula,783,417,366,09
Julio,Jalapa,672,343,329,09
Julio,Jutiapa,829,417,412,09
Julio,Extranjero,8,6,2,09
Julio,Ignorado,41,21,20,09
Agosto,Todos los departamentos,30354,15587,14767,09
Agosto,Guatemala,5037,2566,2471,09
Agosto,El Progreso,337,192,145,09
Agosto,Sacatepéquez,575,294,281,09
Agosto,Chimaltenango,1269,641,628,09
Agosto,Escuintla,1253,628,625,09
Agosto,Santa Rosa,680,364,316,09
Agosto,Sololá,792,421,371,09
Agosto,Totonicapán,1008,527,481,09
Agosto,Quetzaltenango,1536,793,743,09
Agosto,Suchitepéquez,1106,575,531,09
Agosto,Retalhuleu,611,295,316,09
Agosto,San Marcos,2341,1202,1139,09
Agosto,Huehuetenango,2831,1413,1418,09
Agosto,Quiché,2217,1146,1071,09
Agosto,Baja Verapaz,600,306,294,09
Agosto,Alta Verapaz,2889,1500,1389,09
Agosto,Petén,1347,682,665,09
Agosto,Izabal,890,452,438,09
Agosto,Zacapa,555,298,257,09
Agosto,Chiquimula,849,444,405,09
Agosto,Jalapa,655,359,296,09
Agosto,Jutiapa,934,466,468,09
Agosto,Extranjero,10,8,2,09
Agosto,Ignorado,32,15,17,09
Septiembre,Todos los departamentos,31590,16046,15544,09
Septiembre,Guatemala,5231,2656,2575,09
Septiembre,El Progreso,383,198,185,09
Septiembre,Sacatepéquez,619,328,291,09
Septiembre,Chimaltenango,1251,634,617,09
Septiembre,Escuintla,1273,659,614,09
Septiembre,Santa Rosa,733,368,365,09
Septiembre,Sololá,855,419,436,09
Septiembre,Totonicapán,985,473,512,09
Septiembre,Quetzaltenango,1703,880,823,09
Septiembre,Suchitepéquez,1172,570,602,09
Septiembre,Retalhuleu,661,330,331,09
Septiembre,San Marcos,2410,1249,1161,09
Septiembre,Huehuetenango,2794,1434,1360,09
Septiembre,Quiché,2302,1163,1139,09
Septiembre,Baja Verapaz,672,337,335,09
Septiembre,Alta Verapaz,3019,1529,1490,09
Septiembre,Petén,1292,669,623,09
Septiembre,Izabal,942,483,459,09
Septiembre,Zacapa,527,260,267,09
Septiembre,Chiquimula,948,496,452,09
Septiembre,Jalapa,755,378,377,09
Septiembre,Jutiapa,1013,508,505,09
Septiembre,Extranjero,13,8,5,09
Septiembre,Ignorado,37,17,20,09
Octubre,Todos los departamentos,30505,15592,14913,09
Octubre,Guatemala,4950,2539,2411,09
Octubre,El Progreso,328,167,161,09
Octubre,Sacatepéquez,579,317,262,09
Octubre,Chimaltenango,1264,664,600,09
Octubre,Escuintla,1279,624,655,09
Octubre,Santa Rosa,732,369,363,09
Octubre,Sololá,838,418,420,09
Octubre,Totonicapán,894,457,437,09
Octubre,Quetzaltenango,1657,856,801,09
Octubre,Suchitepéquez,1101,583,518,09
Octubre,Retalhuleu,613,321,292,09
Octubre,San Marcos,2413,1208,1205,09
Octubre,Huehuetenango,2872,1445,1427,09
Octubre,Quiché,2212,1128,1084,09
Octubre,Baja Verapaz,612,329,283,09
Octubre,Alta Verapaz,2851,1456,1395,09
Octubre,Petén,1216,610,606,09
Octubre,Izabal,958,475,483,09
Octubre,Zacapa,485,250,235,09
Octubre,Chiquimula,857,452,405,09
Octubre,Jalapa,721,368,353,09
Octubre,Jutiapa,1017,528,489,09
Octubre,Extranjero,15,5,10,09
Octubre,Ignorado,41,23,18,09
Noviembre,Todos los departamentos,28444,14305,14139,09
Noviembre,Guatemala,4548,2264,2284,09
Noviembre,El Progreso,290,148,142,09
Noviembre,Sacatepéquez,488,233,255,09
Noviembre,Chimaltenango,1188,575,613,09
Noviembre,Escuintla,1178,587,591,09
Noviembre,Santa Rosa,682,306,376,09
Noviembre,Sololá,756,369,387,09
Noviembre,Totonicapán,936,491,445,09
Noviembre,Quetzaltenango,1478,737,741,09
Noviembre,Suchitepéquez,1052,536,516,09
Noviembre,Retalhuleu,651,331,320,09
Noviembre,San Marcos,2204,1142,1062,09
Noviembre,Huehuetenango,2681,1359,1322,09
Noviembre,Quiché,2107,1061,1046,09
Noviembre,Baja Verapaz,586,305,281,09
Noviembre,Alta Verapaz,2735,1364,1371,09
Noviembre,Petén,1183,584,599,09
Noviembre,Izabal,806,407,399,09
Noviembre,Zacapa,458,233,225,09
Noviembre,Chiquimula,832,440,392,09
Noviembre,Jalapa,635,319,316,09
Noviembre,Jutiapa,911,483,428,09
Noviembre,Extranjero,14,8,6,09
Noviembre,Ignorado,45,23,22,09
Diciembre,Todos los departamentos,29879,15130,14749,09
Diciembre,Guatemala,4543,2276,2267,09
Diciembre,El Progreso,287,141,146,09
Diciembre,Sacatepéquez,527,265,262,09
Diciembre,Chimaltenango,1237,626,611,09
Diciembre,Escuintla,1234,643,591,09
Diciembre,Santa Rosa,688,356,332,09
Diciembre,Sololá,792,427,365,09
Diciembre,Totonicapán,908,438,470,09
Diciembre,Quetzaltenango,1557,788,769,09
Diciembre,Suchitepéquez,1108,581,527,09
Diciembre,Retalhuleu,632,325,307,09
Diciembre,San Marcos,2384,1199,1185,09
Diciembre,Huehuetenango,2999,1529,1470,09
Diciembre,Quiché,2282,1187,1095,09
Diciembre,Baja Verapaz,636,312,324,09
Diciembre,Alta Verapaz,2940,1478,1462,09
Diciembre,Petén,1196,602,594,09
Diciembre,Izabal,834,411,423,09
Diciembre,Zacapa,501,255,246,09
Diciembre,Chiquimula,916,425,491,09
Diciembre,Jalapa,705,360,345,09
Diciembre,Jutiapa,919,480,439,09
Diciembre,Extranjero,11,9,2,09
Diciembre,Ignorado,43,17,26,09
Todos los meses,Todos los departamentos,361906,183354,178552,10
Todos los meses,Guatemala,59021,29884,29137,10
Todos los meses,El Progreso,3761,1916,1845,10
Todos los meses,Sacatepéquez,6697,3449,3248,10
Todos los meses,Chimaltenango,14998,7509,7489,10
Todos los meses,Escuintla,14342,7314,7028,10
Todos los meses,Santa Rosa,8253,4266,3987,10
Todos los meses,Sololá,9413,4793,4620,10
Todos los meses,Totonicapán,11400,5680,5720,10
Todos los meses,Quetzaltenango,19004,9587,9417,10
Todos los meses,Suchitepéquez,12947,6611,6336,10
Todos los meses,Retalhuleu,7418,3747,3671,10
Todos los meses,San Marcos,29322,14877,14445,10
Todos los meses,Huehuetenango,36390,18471,17919,10
Todos los meses,Quiché,27795,13966,13829,10
Todos los meses,Baja Verapaz,7628,3895,3733,10
Todos los meses,Alta Verapaz,33501,16839,16662,10
Todos los meses,Petén,14147,7208,6939,10
Todos los meses,Izabal,9878,5090,4788,10
Todos los meses,Zacapa,5648,2853,2795,10
Todos los meses,Chiquimula,10400,5366,5034,10
Todos los meses,Jalapa,8548,4247,4301,10
Todos los meses,Jutiapa,11134,5645,5489,10
Todos los meses,Extranjero,113,61,52,10
Todos los meses,Ignorado,148,80,68,10
Enero,Todos los departamentos,30671,15566,15105,10
Enero,Guatemala,5029,2505,2524,10
Enero,El Progreso,297,139,158,10
Enero,Sacatepéquez,578,309,269,10
Enero,Chimaltenango,1235,626,609,10
Enero,Escuintla,1241,648,593,10
Enero,Santa Rosa,688,343,345,10
Enero,Sololá,809,411,398,10
Enero,Totonicapán,934,467,467,10
Enero,Quetzaltenango,1585,784,801,10
Enero,Suchitepéquez,1119,566,553,10
Enero,Retalhuleu,594,291,303,10
Enero,San Marcos,2427,1238,1189,10
Enero,Huehuetenango,3099,1597,1502,10
Enero,Quiché,2538,1290,1248,10
Enero,Baja Verapaz,621,314,307,10
Enero,Alta Verapaz,2778,1426,1352,10
Enero,Petén,1205,593,612,10
Enero,Izabal,760,403,357,10
Enero,Zacapa,471,246,225,10
Enero,Chiquimula,953,529,424,10
Enero,Jalapa,748,375,373,10
Enero,Jutiapa,942,457,485,10
Enero,Extranjero,11,4,7,10
Enero,Ignorado,9,5,4,10
Febrero,Todos los departamentos,26422,13359,13063,10
Febrero,Guatemala,4485,2270,2215,10
Febrero,El Progreso,289,142,147,10
Febrero,Sacatepéquez,451,233,218,10
Febrero,Chimaltenango,1108,565,543,10
Febrero,Escuintla,1069,549,520,10
Febrero,Santa Rosa,646,340,306,10
Febrero,Sololá,704,353,351,10
Febrero,Totonicapán,827,432,395,10
Febrero,Quetzaltenango,1351,676,675,10
Febrero,Suchitepéquez,1009,545,464,10
Febrero,Retalhuleu,513,239,274,10
Febrero,San Marcos,2162,1104,1058,10
Febrero,Huehuetenango,2642,1322,1320,10
Febrero,Quiché,2149,1062,1087,10
Febrero,Baja Verapaz,543,291,252,10
Febrero,Alta Verapaz,2314,1143,1171,10
Febrero,Petén,958,493,465,10
Febrero,Izabal,574,293,281,10
Febrero,Zacapa,415,212,203,10
Febrero,Chiquimula,771,405,366,10
Febrero,Jalapa,622,299,323,10
Febrero,Jutiapa,808,386,422,10
Febrero,Extranjero,9,3,6,10
Febrero,Ignorado,3,2,1,10
Marzo,Todos los departamentos,28756,14454,14302,10
Marzo,Guatemala,5002,2534,2468,10
Marzo,El Progreso,290,120,170,10
Marzo,Sacatepéquez,574,288,286,10
Marzo,Chimaltenango,1220,606,614,10
Marzo,Escuintla,1135,601,534,10
Marzo,Santa Rosa,711,372,339,10
Marzo,Sololá,791,398,393,10
Marzo,Totonicapán,956,457,499,10
Marzo,Quetzaltenango,1552,779,773,10
Marzo,Suchitepéquez,1065,521,544,10
Marzo,Retalhuleu,572,275,297,10
Marzo,San Marcos,2216,1113,1103,10
Marzo,Huehuetenango,2873,1454,1419,10
Marzo,Quiché,2385,1170,1215,10
Marzo,Baja Verapaz,616,315,301,10
Marzo,Alta Verapaz,2315,1151,1164,10
Marzo,Petén,1031,521,510,10
Marzo,Izabal,676,351,325,10
Marzo,Zacapa,413,207,206,10
Marzo,Chiquimula,800,412,388,10
Marzo,Jalapa,678,347,331,10
Marzo,Jutiapa,870,453,417,10
Marzo,Extranjero,9,6,3,10
Marzo,Ignorado,6,3,3,10
Abril,Todos los departamentos,27682,14190,13492,10
Abril,Guatemala,4823,2440,2383,10
Abril,El Progreso,270,129,141,10
Abril,Sacatepéquez,543,295,248,10
Abril,Chimaltenango,1215,618,597,10
Abril,Escuintla,1030,513,517,10
Abril,Santa Rosa,660,317,343,10
Abril,Sololá,725,386,339,10
Abril,Totonicapán,920,451,469,10
Abril,Quetzaltenango,1442,754,688,10
Abril,Suchitepéquez,972,518,454,10
Abril,Retalhuleu,547,270,277,10
Abril,San Marcos,2265,1179,1086,10
Abril,Huehuetenango,2710,1412,1298,10
Abril,Quiché,2196,1137,1059,10
Abril,Baja Verapaz,590,305,285,10
Abril,Alta Verapaz,2386,1228,1158,10
Abril,Petén,1031,528,503,10
Abril,Izabal,692,347,345,10
Abril,Zacapa,402,207,195,10
Abril,Chiquimula,781,406,375,10
Abril,Jalapa,672,320,352,10
Abril,Jutiapa,790,419,371,10
Abril,Extranjero,15,11,4,10
Abril,Ignorado,5,0,5,10
Mayo,Todos los departamentos,28832,14559,14273,10
Mayo,Guatemala,4891,2479,2412,10
Mayo,El Progreso,330,171,159,10
Mayo,Sacatepéquez,552,279,273,10
Mayo,Chimaltenango,1190,606,584,10
Mayo,Escuintla,1162,590,572,10
Mayo,Santa Rosa,617,306,311,10
Mayo,Sololá,766,355,411,10
Mayo,Totonicapán,913,440,473,10
Mayo,Quetzaltenango,1469,733,736,10
Mayo,Suchitepéquez,1004,516,488,10
Mayo,Retalhuleu,559,286,273,10
Mayo,San Marcos,2281,1124,1157,10
Mayo,Huehuetenango,2967,1520,1447,10
Mayo,Quiché,2297,1164,1133,10
Mayo,Baja Verapaz,614,314,300,10
Mayo,Alta Verapaz,2503,1240,1263,10
Mayo,Petén,1117,567,550,10
Mayo,Izabal,747,364,383,10
Mayo,Zacapa,427,235,192,10
Mayo,Chiquimula,815,430,385,10
Mayo,Jalapa,715,366,349,10
Mayo,Jutiapa,869,456,413,10
Mayo,Extranjero,10,9,1,10
Mayo,Ignorado,17,9,8,10
Junio,Todos los departamentos,28124,14392,13732,10
Junio,Guatemala,4906,2534,2372,10
Junio,El Progreso,271,139,132,10
Junio,Sacatepéquez,536,271,265,10
Junio,Chimaltenango,1204,591,613,10
Junio,Escuintla,1091,581,510,10
Junio,Santa Rosa,630,332,298,10
Junio,Sololá,717,375,342,10
Junio,Totonicapán,920,444,476,10
Junio,Quetzaltenango,1481,747,734,10
Junio,Suchitepéquez,953,493,460,10
Junio,Retalhuleu,514,252,262,10
Junio,San Marcos,2316,1184,1132,10
Junio,Huehuetenango,2714,1378,1336,10
Junio,Quiché,2214,1142,1072,10
Junio,Baja Verapaz,619,343,276,10
Junio,Alta Verapaz,2479,1263,1216,10
Junio,Petén,1006,504,502,10
Junio,Izabal,666,348,318,10
Junio,Zacapa,467,241,226,10
Junio,Chiquimula,836,434,402,10
Junio,Jalapa,660,332,328,10
Junio,Jutiapa,902,455,447,10
Junio,Extranjero,9,4,5,10
Junio,Ignorado,13,5,8,10
Julio,Todos los departamentos,29511,15033,14478,10
Julio,Guatemala,4834,2505,2329,10
Julio,El Progreso,314,168,146,10
Julio,Sacatepéquez,528,268,260,10
Julio,Chimaltenango,1247,626,621,10
Julio,Escuintla,1128,555,573,10
Julio,Santa Rosa,668,344,324,10
Julio,Sololá,808,410,398,10
Julio,Totonicapán,903,423,480,10
Julio,Quetzaltenango,1590,814,776,10
Julio,Suchitepéquez,1103,571,532,10
Julio,Retalhuleu,603,318,285,10
Julio,San Marcos,2325,1207,1118,10
Julio,Huehuetenango,2986,1514,1472,10
Julio,Quiché,2397,1188,1209,10
Julio,Baja Verapaz,602,302,300,10
Julio,Alta Verapaz,2680,1404,1276,10
Julio,Petén,1125,580,545,10
Julio,Izabal,798,397,401,10
Julio,Zacapa,481,238,243,10
Julio,Chiquimula,830,440,390,10
Julio,Jalapa,670,325,345,10
Julio,Jutiapa,870,429,441,10
Julio,Extranjero,9,2,7,10
Julio,Ignorado,12,5,7,10
Agosto,Todos los departamentos,31502,15906,15596,10
Agosto,Guatemala,5056,2528,2528,10
Agosto,El Progreso,334,176,158,10
Agosto,Sacatepéquez,589,280,309,10
Agosto,Chimaltenango,1353,672,681,10
Agosto,Escuintla,1310,666,644,10
Agosto,Santa Rosa,719,391,328,10
Agosto,Sololá,772,387,385,10
Agosto,Totonicapán,987,499,488,10
Agosto,Quetzaltenango,1715,867,848,10
Agosto,Suchitepéquez,1143,586,557,10
Agosto,Retalhuleu,672,368,304,10
Agosto,San Marcos,2463,1274,1189,10
Agosto,Huehuetenango,3097,1566,1531,10
Agosto,Quiché,2286,1132,1154,10
Agosto,Baja Verapaz,641,331,310,10
Agosto,Alta Verapaz,3033,1508,1525,10
Agosto,Petén,1281,663,618,10
Agosto,Izabal,978,499,479,10
Agosto,Zacapa,541,259,282,10
Agosto,Chiquimula,858,430,428,10
Agosto,Jalapa,720,352,368,10
Agosto,Jutiapa,929,456,473,10
Agosto,Extranjero,7,4,3,10
Agosto,Ignorado,18,12,6,10
Septiembre,Todos los departamentos,34130,17155,16975,10
Septiembre,Guatemala,5316,2662,2654,10
Septiembre,El Progreso,382,191,191,10
Septiembre,Sacatepéquez,619,309,310,10
Septiembre,Chimaltenango,1363,678,685,10
Septiembre,Escuintla,1409,699,710,10
Septiembre,Santa Rosa,776,418,358,10
Septiembre,Sololá,878,442,436,10
Septiembre,Totonicapán,1050,555,495,10
Septiembre,Quetzaltenango,1871,906,965,10
Septiembre,Suchitepéquez,1196,579,617,10
Septiembre,Retalhuleu,779,385,394,10
Septiembre,San Marcos,2797,1427,1370,10
Septiembre,Huehuetenango,3419,1733,1686,10
Septiembre,Quiché,2385,1163,1222,10
Septiembre,Baja Verapaz,721,351,370,10
Septiembre,Alta Verapaz,3452,1740,1712,10
Septiembre,Petén,1353,690,663,10
Septiembre,Izabal,1034,530,504,10
Septiembre,Zacapa,509,255,254,10
Septiembre,Chiquimula,975,489,486,10
Septiembre,Jalapa,803,417,386,10
Septiembre,Jutiapa,1015,520,495,10
Septiembre,Extranjero,11,5,6,10
Septiembre,Ignorado,17,11,6,10
Octubre,Todos los departamentos,33355,16958,16397,10
Octubre,Guatemala,4936,2504,2432,10
Octubre,El Progreso,371,212,159,10
Octubre,Sacatepéquez,565,289,276,10
Octubre,Chimaltenango,1306,674,632,10
Octubre,Escuintla,1286,651,635,10
Octubre,Santa Rosa,735,359,376,10
Octubre,Sololá,816,441,375,10
Octubre,Totonicapán,975,491,484,10
Octubre,Quetzaltenango,1724,884,840,10
Octubre,Suchitepéquez,1227,636,591,10
Octubre,Retalhuleu,746,378,368,10
Octubre,San Marcos,2902,1463,1439,10
Octubre,Huehuetenango,3412,1738,1674,10
Octubre,Quiché,2394,1185,1209,10
Octubre,Baja Verapaz,743,364,379,10
Octubre,Alta Verapaz,3381,1670,1711,10
Octubre,Petén,1442,765,677,10
Octubre,Izabal,1104,602,502,10
Octubre,Zacapa,525,257,268,10
Octubre,Chiquimula,938,470,468,10
Octubre,Jalapa,757,368,389,10
Octubre,Jutiapa,1043,538,505,10
Octubre,Extranjero,8,5,3,10
Octubre,Ignorado,19,14,5,10
Noviembre,Todos los departamentos,30854,15636,15218,10
Noviembre,Guatemala,4843,2469,2374,10
Noviembre,El Progreso,293,155,138,10
Noviembre,Sacatepéquez,577,321,256,10
Noviembre,Chimaltenango,1252,598,654,10
Noviembre,Escuintla,1229,626,603,10
Noviembre,Santa Rosa,680,360,320,10
Noviembre,Sololá,782,409,373,10
Noviembre,Totonicapán,955,470,485,10
Noviembre,Quetzaltenango,1607,802,805,10
Noviembre,Suchitepéquez,1063,547,516,10
Noviembre,Retalhuleu,700,362,338,10
Noviembre,San Marcos,2546,1304,1242,10
Noviembre,Huehuetenango,3133,1541,1592,10
Noviembre,Quiché,2150,1115,1035,10
Noviembre,Baja Verapaz,629,325,304,10
Noviembre,Alta Verapaz,3062,1552,1510,10
Noviembre,Petén,1274,647,627,10
Noviembre,Izabal,927,480,447,10
Noviembre,Zacapa,496,256,240,10
Noviembre,Chiquimula,881,438,443,10
Noviembre,Jalapa,734,350,384,10
Noviembre,Jutiapa,1025,502,523,10
Noviembre,Extranjero,8,2,6,10
Noviembre,Ignorado,8,5,3,10
Diciembre,Todos los departamentos,32067,16146,15921,10
Diciembre,Guatemala,4900,2454,2446,10
Diciembre,El Progreso,320,174,146,10
Diciembre,Sacatepéquez,585,307,278,10
Diciembre,Chimaltenango,1305,649,656,10
Diciembre,Escuintla,1252,635,617,10
Diciembre,Santa Rosa,723,384,339,10
Diciembre,Sololá,845,426,419,10
Diciembre,Totonicapán,1060,551,509,10
Diciembre,Quetzaltenango,1617,841,776,10
Diciembre,Suchitepéquez,1093,533,560,10
Diciembre,Retalhuleu,619,323,296,10
Diciembre,San Marcos,2622,1260,1362,10
Diciembre,Huehuetenango,3338,1696,1642,10
Diciembre,Quiché,2404,1218,1186,10
Diciembre,Baja Verapaz,689,340,349,10
Diciembre,Alta Verapaz,3118,1514,1604,10
Diciembre,Petén,1324,657,667,10
Diciembre,Izabal,922,476,446,10
Diciembre,Zacapa,501,240,261,10
Diciembre,Chiquimula,962,483,479,10
Diciembre,Jalapa,769,396,373,10
Diciembre,Jutiapa,1071,574,497,10
Diciembre,Extranjero,7,6,1,10
Diciembre,Ignorado,21,9,12,10
Todos los meses,Todos los departamentos,373692,189724,183968,11
Todos los meses,Guatemala,61951,31520,30431,11
Todos los meses,El Progreso,4092,2118,1974,11
Todos los meses,Sacatepéquez,6845,3454,3391,11
Todos los meses,Chimaltenango,15303,7777,7526,11
Todos los meses,Escuintla,15800,8036,7764,11
Todos los meses,Santa Rosa,9022,4589,4433,11
Todos los meses,Sololá,9555,4816,4739,11
Todos los meses,Totonicapán,11724,5959,5765,11
Todos los meses,Quetzaltenango,19858,10105,9753,11
Todos los meses,Suchitepéquez,13782,6971,6811,11
Todos los meses,Retalhuleu,7894,4058,3836,11
Todos los meses,San Marcos,29742,15145,14597,11
Todos los meses,Huehuetenango,36713,18433,18280,11
Todos los meses,Quiché,28392,14519,13873,11
Todos los meses,Baja Verapaz,7760,3961,3799,11
Todos los meses,Alta Verapaz,33382,16955,16427,11
Todos los meses,Petén,14383,7253,7130,11
Todos los meses,Izabal,10137,5101,5036,11
Todos los meses,Zacapa,6001,3048,2953,11
Todos los meses,Chiquimula,10721,5417,5304,11
Todos los meses,Jalapa,9022,4620,4402,11
Todos los meses,Jutiapa,11335,5737,5598,11
Todos los meses,Extranjero,158,77,81,11
Todos los meses,Ignorado,120,55,65,11
Enero,Todos los departamentos,30766,15710,15056,11
Enero,Guatemala,4960,2534,2426,11
Enero,El Progreso,338,167,171,11
Enero,Sacatepéquez,582,316,266,11
Enero,Chimaltenango,1266,637,629,11
Enero,Escuintla,1257,639,618,11
Enero,Santa Rosa,697,344,353,11
Enero,Sololá,743,372,371,11
Enero,Totonicapán,986,504,482,11
Enero,Quetzaltenango,1670,868,802,11
Enero,Suchitepéquez,1074,539,535,11
Enero,Retalhuleu,594,309,285,11
Enero,San Marcos,2480,1219,1261,11
Enero,Huehuetenango,3158,1595,1563,11
Enero,Quiché,2406,1257,1149,11
Enero,Baja Verapaz,681,349,332,11
Enero,Alta Verapaz,2756,1404,1352,11
Enero,Petén,1110,565,545,11
Enero,Izabal,791,403,388,11
Enero,Zacapa,485,256,229,11
Enero,Chiquimula,969,500,469,11
Enero,Jalapa,777,428,349,11
Enero,Jutiapa,954,489,465,11
Enero,Extranjero,13,6,7,11
Enero,Ignorado,19,10,9,11
Febrero,Todos los departamentos,26716,13639,13077,11
Febrero,Guatemala,4606,2362,2244,11
Febrero,El Progreso,271,145,126,11
Febrero,Sacatepéquez,498,260,238,11
Febrero,Chimaltenango,1060,543,517,11
Febrero,Escuintla,1017,544,473,11
Febrero,Santa Rosa,593,296,297,11
Febrero,Sololá,716,366,350,11
Febrero,Totonicapán,863,447,416,11
Febrero,Quetzaltenango,1463,770,693,11
Febrero,Suchitepéquez,932,504,428,11
Febrero,Retalhuleu,539,271,268,11
Febrero,San Marcos,2228,1116,1112,11
Febrero,Huehuetenango,2732,1372,1360,11
Febrero,Quiché,2132,1090,1042,11
Febrero,Baja Verapaz,566,292,274,11
Febrero,Alta Verapaz,2318,1157,1161,11
Febrero,Petén,909,438,471,11
Febrero,Izabal,597,307,290,11
Febrero,Zacapa,397,199,198,11
Febrero,Chiquimula,808,416,392,11
Febrero,Jalapa,615,306,309,11
Febrero,Jutiapa,833,427,406,11
Febrero,Extranjero,13,8,5,11
Febrero,Ignorado,10,3,7,11
Marzo,Todos los departamentos,30161,15360,14801,11
Marzo,Guatemala,5256,2622,2634,11
Marzo,El Progreso,329,167,162,11
Marzo,Sacatepéquez,577,271,306,11
Marzo,Chimaltenango,1296,650,646,11
Marzo,Escuintla,1172,607,565,11
Marzo,Santa Rosa,687,346,341,11
Marzo,Sololá,851,466,385,11
Marzo,Totonicapán,942,488,454,11
Marzo,Quetzaltenango,1656,856,800,11
Marzo,Suchitepéquez,1112,593,519,11
Marzo,Retalhuleu,641,307,334,11
Marzo,San Marcos,2502,1256,1246,11
Marzo,Huehuetenango,2957,1489,1468,11
Marzo,Quiché,2390,1229,1161,11
Marzo,Baja Verapaz,630,309,321,11
Marzo,Alta Verapaz,2426,1259,1167,11
Marzo,Petén,1047,547,500,11
Marzo,Izabal,740,371,369,11
Marzo,Zacapa,443,221,222,11
Marzo,Chiquimula,793,408,385,11
Marzo,Jalapa,760,403,357,11
Marzo,Jutiapa,927,486,441,11
Marzo,Extranjero,13,4,9,11
Marzo,Ignorado,14,5,9,11
Abril,Todos los departamentos,29295,14904,14391,11
Abril,Guatemala,4847,2576,2271,11
Abril,El Progreso,313,156,157,11
Abril,Sacatepéquez,583,295,288,11
Abril,Chimaltenango,1171,585,586,11
Abril,Escuintla,1329,661,668,11
Abril,Santa Rosa,701,341,360,11
Abril,Sololá,779,413,366,11
Abril,Totonicapán,976,495,481,11
Abril,Quetzaltenango,1588,812,776,11
Abril,Suchitepéquez,1114,564,550,11
Abril,Retalhuleu,660,332,328,11
Abril,San Marcos,2308,1196,1112,11
Abril,Huehuetenango,2939,1520,1419,11
Abril,Quiché,2322,1179,1143,11
Abril,Baja Verapaz,612,296,316,11
Abril,Alta Verapaz,2429,1208,1221,11
Abril,Petén,1060,558,502,11
Abril,Izabal,700,342,358,11
Abril,Zacapa,438,202,236,11
Abril,Chiquimula,848,417,431,11
Abril,Jalapa,699,334,365,11
Abril,Jutiapa,856,408,448,11
Abril,Extranjero,13,9,4,11
Abril,Ignorado,10,5,5,11
Mayo,Todos los departamentos,31009,15731,15278,11
Mayo,Guatemala,5288,2686,2602,11
Mayo,El Progreso,360,176,184,11
Mayo,Sacatepéquez,605,290,315,11
Mayo,Chimaltenango,1263,652,611,11
Mayo,Escuintla,1333,668,665,11
Mayo,Santa Rosa,736,376,360,11
Mayo,Sololá,801,394,407,11
Mayo,Totonicapán,959,491,468,11
Mayo,Quetzaltenango,1637,788,849,11
Mayo,Suchitepéquez,1149,588,561,11
Mayo,Retalhuleu,635,339,296,11
Mayo,San Marcos,2447,1264,1183,11
Mayo,Huehuetenango,2985,1490,1495,11
Mayo,Quiché,2481,1242,1239,11
Mayo,Baja Verapaz,638,353,285,11
Mayo,Alta Verapaz,2719,1385,1334,11
Mayo,Petén,1156,618,538,11
Mayo,Izabal,810,428,382,11
Mayo,Zacapa,497,263,234,11
Mayo,Chiquimula,849,443,406,11
Mayo,Jalapa,718,341,377,11
Mayo,Jutiapa,909,439,470,11
Mayo,Extranjero,19,11,8,11
Mayo,Ignorado,15,6,9,11
Junio,Todos los departamentos,29862,15084,14778,11
Junio,Guatemala,5073,2579,2494,11
Junio,El Progreso,285,151,134,11
Junio,Sacatepéquez,559,295,264,11
Junio,Chimaltenango,1213,600,613,11
Junio,Escuintla,1321,667,654,11
Junio,Santa Rosa,727,368,359,11
Junio,Sololá,773,366,407,11
Junio,Totonicapán,942,480,462,11
Junio,Quetzaltenango,1553,817,736,11
Junio,Suchitepéquez,1093,528,565,11
Junio,Retalhuleu,608,335,273,11
Junio,San Marcos,2381,1212,1169,11
Junio,Huehuetenango,2939,1444,1495,11
Junio,Quiché,2375,1190,1185,11
Junio,Baja Verapaz,654,331,323,11
Junio,Alta Verapaz,2552,1292,1260,11
Junio,Petén,1096,535,561,11
Junio,Izabal,778,396,382,11
Junio,Zacapa,462,230,232,11
Junio,Chiquimula,863,431,432,11
Junio,Jalapa,696,373,323,11
Junio,Jutiapa,902,455,447,11
Junio,Extranjero,8,6,2,11
Junio,Ignorado,9,3,6,11
Julio,Todos los departamentos,32031,16222,15809,11
Julio,Guatemala,5407,2740,2667,11
Julio,El Progreso,362,213,149,11
Julio,Sacatepéquez,600,300,300,11
Julio,Chimaltenango,1383,689,694,11
Julio,Escuintla,1351,664,687,11
Julio,Santa Rosa,801,408,393,11
Julio,Sololá,780,395,385,11
Julio,Totonicapán,955,468,487,11
Julio,Quetzaltenango,1620,833,787,11
Julio,Suchitepéquez,1179,595,584,11
Julio,Retalhuleu,690,355,335,11
Julio,San Marcos,2447,1262,1185,11
Julio,Huehuetenango,3069,1558,1511,11
Julio,Quiché,2419,1258,1161,11
Julio,Baja Verapaz,685,359,326,11
Julio,Alta Verapaz,2884,1476,1408,11
Julio,Petén,1277,607,670,11
Julio,Izabal,956,467,489,11
Julio,Zacapa,519,257,262,11
Julio,Chiquimula,884,439,445,11
Julio,Jalapa,734,371,363,11
Julio,Jutiapa,1013,501,512,11
Julio,Extranjero,7,2,5,11
Julio,Ignorado,9,5,4,11
Agosto,Todos los departamentos,32573,16626,15947,11
Agosto,Guatemala,5542,2843,2699,11
Agosto,El Progreso,368,180,188,11
Agosto,Sacatepéquez,600,278,322,11
Agosto,Chimaltenango,1259,640,619,11
Agosto,Escuintla,1335,702,633,11
Agosto,Santa Rosa,796,440,356,11
Agosto,Sololá,799,388,411,11
Agosto,Totonicapán,998,527,471,11
Agosto,Quetzaltenango,1743,866,877,11
Agosto,Suchitepéquez,1200,583,617,11
Agosto,Retalhuleu,704,354,350,11
Agosto,San Marcos,2512,1263,1249,11
Agosto,Huehuetenango,3036,1482,1554,11
Agosto,Quiché,2340,1232,1108,11
Agosto,Baja Verapaz,680,345,335,11
Agosto,Alta Verapaz,3057,1635,1422,11
Agosto,Petén,1401,709,692,11
Agosto,Izabal,1022,510,512,11
Agosto,Zacapa,543,268,275,11
Agosto,Chiquimula,887,461,426,11
Agosto,Jalapa,727,384,343,11
Agosto,Jutiapa,1001,522,479,11
Agosto,Extranjero,17,10,7,11
Agosto,Ignorado,6,4,2,11
Septiembre,Todos los departamentos,34133,17208,16925,11
Septiembre,Guatemala,5520,2732,2788,11
Septiembre,El Progreso,429,224,205,11
Septiembre,Sacatepéquez,603,305,298,11
Septiembre,Chimaltenango,1407,764,643,11
Septiembre,Escuintla,1522,774,748,11
Septiembre,Santa Rosa,829,421,408,11
Septiembre,Sololá,817,430,387,11
Septiembre,Totonicapán,1108,545,563,11
Septiembre,Quetzaltenango,1802,920,882,11
Septiembre,Suchitepéquez,1287,622,665,11
Septiembre,Retalhuleu,750,379,371,11
Septiembre,San Marcos,2671,1359,1312,11
Septiembre,Huehuetenango,3201,1585,1616,11
Septiembre,Quiché,2392,1182,1210,11
Septiembre,Baja Verapaz,680,336,344,11
Septiembre,Alta Verapaz,3134,1576,1558,11
Septiembre,Petén,1424,728,696,11
Septiembre,Izabal,1099,566,533,11
Septiembre,Zacapa,596,310,286,11
Septiembre,Chiquimula,962,494,468,11
Septiembre,Jalapa,837,435,402,11
Septiembre,Jutiapa,1042,511,531,11
Septiembre,Extranjero,14,6,8,11
Septiembre,Ignorado,7,4,3,11
Octubre,Todos los departamentos,33327,16879,16448,11
Octubre,Guatemala,5373,2641,2732,11
Octubre,El Progreso,357,189,168,11
Octubre,Sacatepéquez,531,281,250,11
Octubre,Chimaltenango,1345,672,673,11
Octubre,Escuintla,1456,729,727,11
Octubre,Santa Rosa,791,409,382,11
Octubre,Sololá,855,420,435,11
Octubre,Totonicapán,1035,538,497,11
Octubre,Quetzaltenango,1693,863,830,11
Octubre,Suchitepéquez,1248,632,616,11
Octubre,Retalhuleu,758,390,368,11
Octubre,San Marcos,2664,1392,1272,11
Octubre,Huehuetenango,3306,1686,1620,11
Octubre,Quiché,2419,1220,1199,11
Octubre,Baja Verapaz,668,358,310,11
Octubre,Alta Verapaz,3157,1568,1589,11
Octubre,Petén,1366,693,673,11
Octubre,Izabal,921,467,454,11
Octubre,Zacapa,566,292,274,11
Octubre,Chiquimula,969,493,476,11
Octubre,Jalapa,815,408,407,11
Octubre,Jutiapa,1009,527,482,11
Octubre,Extranjero,14,6,8,11
Octubre,Ignorado,11,5,6,11
Noviembre,Todos los departamentos,31767,16060,15707,11
Noviembre,Guatemala,5071,2633,2438,11
Noviembre,El Progreso,341,178,163,11
Noviembre,Sacatepéquez,556,274,282,11
Noviembre,Chimaltenango,1260,638,622,11
Noviembre,Escuintla,1384,707,677,11
Noviembre,Santa Rosa,837,421,416,11
Noviembre,Sololá,802,390,412,11
Noviembre,Totonicapán,972,501,471,11
Noviembre,Quetzaltenango,1671,847,824,11
Noviembre,Suchitepéquez,1211,616,595,11
Noviembre,Retalhuleu,679,351,328,11
Noviembre,San Marcos,2501,1265,1236,11
Noviembre,Huehuetenango,3157,1591,1566,11
Noviembre,Quiché,2333,1204,1129,11
Noviembre,Baja Verapaz,608,290,318,11
Noviembre,Alta Verapaz,2984,1501,1483,11
Noviembre,Petén,1288,627,661,11
Noviembre,Izabal,862,398,464,11
Noviembre,Zacapa,539,277,262,11
Noviembre,Chiquimula,917,424,493,11
Noviembre,Jalapa,832,429,403,11
Noviembre,Jutiapa,943,492,451,11
Noviembre,Extranjero,12,3,9,11
Noviembre,Ignorado,7,3,4,11
Diciembre,Todos los departamentos,32052,16301,15751,11
Diciembre,Guatemala,5008,2572,2436,11
Diciembre,El Progreso,339,172,167,11
Diciembre,Sacatepéquez,551,289,262,11
Diciembre,Chimaltenango,1380,707,673,11
Diciembre,Escuintla,1323,674,649,11
Diciembre,Santa Rosa,827,419,408,11
Diciembre,Sololá,839,416,423,11
Diciembre,Totonicapán,988,475,513,11
Diciembre,Quetzaltenango,1762,865,897,11
Diciembre,Suchitepéquez,1183,607,576,11
Diciembre,Retalhuleu,636,336,300,11
Diciembre,San Marcos,2601,1341,1260,11
Diciembre,Huehuetenango,3234,1621,1613,11
Diciembre,Quiché,2383,1236,1147,11
Diciembre,Baja Verapaz,658,343,315,11
Diciembre,Alta Verapaz,2966,1494,1472,11
Diciembre,Petén,1249,628,621,11
Diciembre,Izabal,861,446,415,11
Diciembre,Zacapa,516,273,243,11
Diciembre,Chiquimula,972,491,481,11
Diciembre,Jalapa,812,408,404,11
Diciembre,Jutiapa,946,480,466,11
Diciembre,Extranjero,15,6,9,11
Diciembre,Ignorado,3,2,1,11
Todos los meses,Todos los departamentos,388613,197277,191336,12
Todos los meses,Guatemala,64478,32963,31515,12
Todos los meses,El Progreso,4042,1994,2048,12
Todos los meses,Sacatepéquez,6988,3546,3442,12
Todos los meses,Chimaltenango,15868,8003,7865,12
Todos los meses,Escuintla,16454,8349,8105,12
Todos los meses,Santa Rosa,9601,4883,4718,12
Todos los meses,Sololá,9871,5033,4838,12
Todos los meses,Totonicapán,12195,6185,6010,12
Todos los meses,Quetzaltenango,21031,10664,10367,12
Todos los meses,Suchitepéquez,14147,7138,7009,12
Todos los meses,Retalhuleu,8207,4203,4004,12
Todos los meses,San Marcos,30389,15463,14926,12
Todos los meses,Huehuetenango,38477,19483,18994,12
Todos los meses,Quiché,29590,15070,14520,12
Todos los meses,Baja Verapaz,7951,4039,3912,12
Todos los meses,Alta Verapaz,34986,17632,17354,12
Todos los meses,Petén,15353,7763,7590,12
Todos los meses,Izabal,10122,5180,4942,12
Todos los meses,Zacapa,6129,3104,3025,12
Todos los meses,Chiquimula,11488,5806,5682,12
Todos los meses,Jalapa,9284,4738,4546,12
Todos los meses,Jutiapa,11789,5941,5848,12
Todos los meses,Extranjero,139,83,56,12
Todos los meses,Ignorado,34,14,20,12
Enero,Todos los departamentos,33127,16774,16353,12
Enero,Guatemala,5321,2746,2575,12
Enero,El Progreso,335,183,152,12
Enero,Sacatepéquez,605,300,305,12
Enero,Chimaltenango,1335,648,687,12
Enero,Escuintla,1373,692,681,12
Enero,Santa Rosa,803,397,406,12
Enero,Sololá,875,450,425,12
Enero,Totonicapán,1035,507,528,12
Enero,Quetzaltenango,1767,858,909,12
Enero,Suchitepéquez,1219,628,591,12
Enero,Retalhuleu,641,343,298,12
Enero,San Marcos,2528,1258,1270,12
Enero,Huehuetenango,3408,1727,1681,12
Enero,Quiché,2786,1397,1389,12
Enero,Baja Verapaz,734,354,380,12
Enero,Alta Verapaz,2970,1530,1440,12
Enero,Petén,1197,588,609,12
Enero,Izabal,825,407,418,12
Enero,Zacapa,511,274,237,12
Enero,Chiquimula,1000,521,479,12
Enero,Jalapa,798,413,385,12
Enero,Jutiapa,1048,544,504,12
Enero,Extranjero,9,8,1,12
Enero,Ignorado,4,1,3,12
Febrero,Todos los departamentos,29541,14858,14683,12
Febrero,Guatemala,5083,2625,2458,12
Febrero,El Progreso,284,127,157,12
Febrero,Sacatepéquez,569,273,296,12
Febrero,Chimaltenango,1320,643,677,12
Febrero,Escuintla,1183,584,599,12
Febrero,Santa Rosa,695,351,344,12
Febrero,Sololá,793,404,389,12
Febrero,Totonicapán,928,466,462,12
Febrero,Quetzaltenango,1617,787,830,12
Febrero,Suchitepéquez,1123,555,568,12
Febrero,Retalhuleu,573,296,277,12
Febrero,San Marcos,2335,1157,1178,12
Febrero,Huehuetenango,3027,1516,1511,12
Febrero,Quiché,2349,1181,1168,12
Febrero,Baja Verapaz,664,344,320,12
Febrero,Alta Verapaz,2471,1256,1215,12
Febrero,Petén,1010,526,484,12
Febrero,Izabal,645,317,328,12
Febrero,Zacapa,410,212,198,12
Febrero,Chiquimula,870,428,442,12
Febrero,Jalapa,723,372,351,12
Febrero,Jutiapa,855,433,422,12
Febrero,Extranjero,10,3,7,12
Febrero,Ignorado,4,2,2,12
Marzo,Todos los departamentos,31716,16105,15611,12
Marzo,Guatemala,5567,2859,2708,12
Marzo,El Progreso,322,159,163,12
Marzo,Sacatepéquez,595,322,273,12
Marzo,Chimaltenango,1353,704,649,12
Marzo,Escuintla,1317,645,672,12
Marzo,Santa Rosa,840,437,403,12
Marzo,Sololá,853,410,443,12
Marzo,Totonicapán,964,500,464,12
Marzo,Quetzaltenango,1721,888,833,12
Marzo,Suchitepéquez,1170,568,602,12
Marzo,Retalhuleu,644,350,294,12
Marzo,San Marcos,2560,1301,1259,12
Marzo,Huehuetenango,3276,1683,1593,12
Marzo,Quiché,2500,1255,1245,12
Marzo,Baja Verapaz,703,329,374,12
Marzo,Alta Verapaz,2493,1207,1286,12
Marzo,Petén,1119,579,540,12
Marzo,Izabal,712,370,342,12
Marzo,Zacapa,489,246,243,12
Marzo,Chiquimula,823,429,394,12
Marzo,Jalapa,780,417,363,12
Marzo,Jutiapa,905,441,464,12
Marzo,Extranjero,9,6,3,12
Marzo,Ignorado,1,0,1,12
Abril,Todos los departamentos,30063,15225,14838,12
Abril,Guatemala,5127,2582,2545,12
Abril,El Progreso,342,172,170,12
Abril,Sacatepéquez,544,279,265,12
Abril,Chimaltenango,1247,644,603,12
Abril,Escuintla,1259,650,609,12
Abril,Santa Rosa,745,368,377,12
Abril,Sololá,755,386,369,12
Abril,Totonicapán,990,520,470,12
Abril,Quetzaltenango,1628,808,820,12
Abril,Suchitepéquez,1127,557,570,12
Abril,Retalhuleu,641,306,335,12
Abril,San Marcos,2409,1203,1206,12
Abril,Huehuetenango,3025,1512,1513,12
Abril,Quiché,2393,1229,1164,12
Abril,Baja Verapaz,616,331,285,12
Abril,Alta Verapaz,2505,1265,1240,12
Abril,Petén,1203,601,602,12
Abril,Izabal,706,349,357,12
Abril,Zacapa,414,213,201,12
Abril,Chiquimula,821,424,397,12
Abril,Jalapa,670,368,302,12
Abril,Jutiapa,885,453,432,12
Abril,Extranjero,6,3,3,12
Abril,Ignorado,5,2,3,12
Mayo,Todos los departamentos,31938,16251,15687,12
Mayo,Guatemala,5479,2744,2735,12
Mayo,El Progreso,321,164,157,12
Mayo,Sacatepéquez,571,297,274,12
Mayo,Chimaltenango,1246,643,603,12
Mayo,Escuintla,1301,667,634,12
Mayo,Santa Rosa,778,408,370,12
Mayo,Sololá,783,395,388,12
Mayo,Totonicapán,1032,530,502,12
Mayo,Quetzaltenango,1718,875,843,12
Mayo,Suchitepéquez,1137,604,533,12
Mayo,Retalhuleu,645,313,332,12
Mayo,San Marcos,2520,1309,1211,12
Mayo,Huehuetenango,3253,1640,1613,12
Mayo,Quiché,2488,1264,1224,12
Mayo,Baja Verapaz,667,341,326,12
Mayo,Alta Verapaz,2822,1411,1411,12
Mayo,Petén,1222,653,569,12
Mayo,Izabal,802,422,380,12
Mayo,Zacapa,489,243,246,12
Mayo,Chiquimula,941,449,492,12
Mayo,Jalapa,732,386,346,12
Mayo,Jutiapa,974,483,491,12
Mayo,Extranjero,14,8,6,12
Mayo,Ignorado,3,2,1,12
Junio,Todos los departamentos,30951,15746,15205,12
Junio,Guatemala,5130,2676,2454,12
Junio,El Progreso,338,171,167,12
Junio,Sacatepéquez,571,291,280,12
Junio,Chimaltenango,1309,645,664,12
Junio,Escuintla,1340,678,662,12
Junio,Santa Rosa,758,387,371,12
Junio,Sololá,826,421,405,12
Junio,Totonicapán,988,497,491,12
Junio,Quetzaltenango,1666,862,804,12
Junio,Suchitepéquez,1115,556,559,12
Junio,Retalhuleu,686,361,325,12
Junio,San Marcos,2403,1227,1176,12
Junio,Huehuetenango,2982,1495,1487,12
Junio,Quiché,2390,1236,1154,12
Junio,Baja Verapaz,604,319,285,12
Junio,Alta Verapaz,2805,1416,1389,12
Junio,Petén,1181,580,601,12
Junio,Izabal,787,405,382,12
Junio,Zacapa,476,222,254,12
Junio,Chiquimula,945,459,486,12
Junio,Jalapa,743,370,373,12
Junio,Jutiapa,893,462,431,12
Junio,Extranjero,12,8,4,12
Junio,Ignorado,3,2,1,12
Julio,Todos los departamentos,32183,16389,15794,12
Julio,Guatemala,5361,2772,2589,12
Julio,El Progreso,318,148,170,12
Julio,Sacatepéquez,568,268,300,12
Julio,Chimaltenango,1323,639,684,12
Julio,Escuintla,1390,706,684,12
Julio,Santa Rosa,807,420,387,12
Julio,Sololá,782,400,382,12
Julio,Totonicapán,979,531,448,12
Julio,Quetzaltenango,1817,916,901,12
Julio,Suchitepéquez,1146,592,554,12
Julio,Retalhuleu,638,323,315,12
Julio,San Marcos,2514,1286,1228,12
Julio,Huehuetenango,3098,1591,1507,12
Julio,Quiché,2429,1240,1189,12
Julio,Baja Verapaz,678,333,345,12
Julio,Alta Verapaz,2941,1536,1405,12
Julio,Petén,1301,678,623,12
Julio,Izabal,945,478,467,12
Julio,Zacapa,507,255,252,12
Julio,Chiquimula,929,466,463,12
Julio,Jalapa,722,356,366,12
Julio,Jutiapa,976,448,528,12
Julio,Extranjero,10,7,3,12
Julio,Ignorado,4,0,4,12
Agosto,Todos los departamentos,33739,17229,16510,12
Agosto,Guatemala,5561,2884,2677,12
Agosto,El Progreso,354,165,189,12
Agosto,Sacatepéquez,586,309,277,12
Agosto,Chimaltenango,1370,683,687,12
Agosto,Escuintla,1445,742,703,12
Agosto,Santa Rosa,878,468,410,12
Agosto,Sololá,818,425,393,12
Agosto,Totonicapán,1082,528,554,12
Agosto,Quetzaltenango,1822,949,873,12
Agosto,Suchitepéquez,1231,605,626,12
Agosto,Retalhuleu,727,396,331,12
Agosto,San Marcos,2594,1349,1245,12
Agosto,Huehuetenango,3290,1646,1644,12
Agosto,Quiché,2333,1175,1158,12
Agosto,Baja Verapaz,685,355,330,12
Agosto,Alta Verapaz,3293,1657,1636,12
Agosto,Petén,1388,701,687,12
Agosto,Izabal,1011,520,491,12
Agosto,Zacapa,511,256,255,12
Agosto,Chiquimula,982,505,477,12
Agosto,Jalapa,771,378,393,12
Agosto,Jutiapa,993,526,467,12
Agosto,Extranjero,12,6,6,12
Agosto,Ignorado,2,1,1,12
Septiembre,Todos los departamentos,35320,17940,17380,12
Septiembre,Guatemala,5708,2926,2782,12
Septiembre,El Progreso,374,181,193,12
Septiembre,Sacatepéquez,628,322,306,12
Septiembre,Chimaltenango,1373,697,676,12
Septiembre,Escuintla,1515,805,710,12
Septiembre,Santa Rosa,881,441,440,12
Septiembre,Sololá,888,447,441,12
Septiembre,Totonicapán,1008,514,494,12
Septiembre,Quetzaltenango,1891,965,926,12
Septiembre,Suchitepéquez,1289,669,620,12
Septiembre,Retalhuleu,758,389,369,12
Septiembre,San Marcos,2778,1424,1354,12
Septiembre,Huehuetenango,3397,1753,1644,12
Septiembre,Quiché,2609,1332,1277,12
Septiembre,Baja Verapaz,666,328,338,12
Septiembre,Alta Verapaz,3427,1679,1748,12
Septiembre,Petén,1517,727,790,12
Septiembre,Izabal,960,526,434,12
Septiembre,Zacapa,614,301,313,12
Septiembre,Chiquimula,1047,525,522,12
Septiembre,Jalapa,825,404,421,12
Septiembre,Jutiapa,1150,576,574,12
Septiembre,Extranjero,16,8,8,12
Septiembre,Ignorado,1,1,0,12
Octubre,Todos los departamentos,34611,17401,17210,12
Octubre,Guatemala,5584,2774,2810,12
Octubre,El Progreso,375,192,183,12
Octubre,Sacatepéquez,629,312,317,12
Octubre,Chimaltenango,1344,711,633,12
Octubre,Escuintla,1571,790,781,12
Octubre,Santa Rosa,868,423,445,12
Octubre,Sololá,888,427,461,12
Octubre,Totonicapán,1110,541,569,12
Octubre,Quetzaltenango,1880,955,925,12
Octubre,Suchitepéquez,1256,619,637,12
Octubre,Retalhuleu,770,360,410,12
Octubre,San Marcos,2579,1273,1306,12
Octubre,Huehuetenango,3286,1669,1617,12
Octubre,Quiché,2498,1288,1210,12
Octubre,Baja Verapaz,685,371,314,12
Octubre,Alta Verapaz,3195,1616,1579,12
Octubre,Petén,1482,781,701,12
Octubre,Izabal,985,494,491,12
Octubre,Zacapa,592,286,306,12
Octubre,Chiquimula,1055,542,513,12
Octubre,Jalapa,853,413,440,12
Octubre,Jutiapa,1105,552,553,12
Octubre,Extranjero,19,10,9,12
Octubre,Ignorado,2,2,0,12
Noviembre,Todos los departamentos,32254,16422,15832,12
Noviembre,Guatemala,5216,2647,2569,12
Noviembre,El Progreso,314,156,158,12
Noviembre,Sacatepéquez,554,294,260,12
Noviembre,Chimaltenango,1364,712,652,12
Noviembre,Escuintla,1393,701,692,12
Noviembre,Santa Rosa,782,403,379,12
Noviembre,Sololá,791,418,373,12
Noviembre,Totonicapán,1080,526,554,12
Noviembre,Quetzaltenango,1755,898,857,12
Noviembre,Suchitepéquez,1126,576,550,12
Noviembre,Retalhuleu,732,377,355,12
Noviembre,San Marcos,2542,1315,1227,12
Noviembre,Huehuetenango,3102,1564,1538,12
Noviembre,Quiché,2284,1184,1100,12
Noviembre,Baja Verapaz,595,302,293,12
Noviembre,Alta Verapaz,2936,1455,1481,12
Noviembre,Petén,1374,675,699,12
Noviembre,Izabal,877,443,434,12
Noviembre,Zacapa,544,284,260,12
Noviembre,Chiquimula,1030,539,491,12
Noviembre,Jalapa,825,426,399,12
Noviembre,Jutiapa,1019,516,503,12
Noviembre,Extranjero,14,10,4,12
Noviembre,Ignorado,5,1,4,12
Diciembre,Todos los departamentos,33170,16937,16233,12
Diciembre,Guatemala,5341,2728,2613,12
Diciembre,El Progreso,365,176,189,12
Diciembre,Sacatepéquez,568,279,289,12
Diciembre,Chimaltenango,1284,634,650,12
Diciembre,Escuintla,1367,689,678,12
Diciembre,Santa Rosa,766,380,386,12
Diciembre,Sololá,819,450,369,12
Diciembre,Totonicapán,999,525,474,12
Diciembre,Quetzaltenango,1749,903,846,12
Diciembre,Suchitepéquez,1208,609,599,12
Diciembre,Retalhuleu,752,389,363,12
Diciembre,San Marcos,2627,1361,1266,12
Diciembre,Huehuetenango,3333,1687,1646,12
Diciembre,Quiché,2531,1289,1242,12
Diciembre,Baja Verapaz,654,332,322,12
Diciembre,Alta Verapaz,3128,1604,1524,12
Diciembre,Petén,1359,674,685,12
Diciembre,Izabal,867,449,418,12
Diciembre,Zacapa,572,312,260,12
Diciembre,Chiquimula,1045,519,526,12
Diciembre,Jalapa,842,435,407,12
Diciembre,Jutiapa,986,507,479,12
Diciembre,Extranjero,8,6,2,12
Diciembre,Ignorado,0,0,0,12
Todos los meses,Todos los departamentos,387342,196299,191043,13
Todos los meses,Guatemala,65920,33407,32513,13
Todos los meses,El Progreso,4202,2153,2049,13
Todos los meses,Sacatepéquez,7004,3531,3473,13
Todos los meses,Chimaltenango,15755,8017,7738,13
Todos los meses,Escuintla,16401,8357,8044,13
Todos los meses,Santa Rosa,9478,4804,4674,13
Todos los meses,Sololá,10051,5126,4925,13
Todos los meses,Totonicapán,12239,6151,6088,13
Todos los meses,Quetzaltenango,20265,10291,9974,13
Todos los meses,Suchitepéquez,13920,7095,6825,13
Todos los meses,Retalhuleu,8158,4098,4060,13
Todos los meses,San Marcos,30193,15285,14908,13
Todos los meses,Huehuetenango,37732,18951,18781,13
Todos los meses,Quiché,29359,15030,14329,13
Todos los meses,Baja Verapaz,7889,4106,3783,13
Todos los meses,Alta Verapaz,34119,17158,16961,13
Todos los meses,Petén,15510,7869,7641,13
Todos los meses,Izabal,10404,5223,5181,13
Todos los meses,Zacapa,6132,3135,2997,13
Todos los meses,Chiquimula,10954,5623,5331,13
Todos los meses,Jalapa,9556,4856,4700,13
Todos los meses,Jutiapa,11836,5909,5927,13
Todos los meses,Extranjero,225,110,115,13
Todos los meses,Ignorado,40,14,26,13
Enero,Todos los departamentos,33130,16568,16562,13
Enero,Guatemala,5605,2800,2805,13
Enero,El Progreso,316,149,167,13
Enero,Sacatepéquez,581,300,281,13
Enero,Chimaltenango,1308,674,634,13
Enero,Escuintla,1333,660,673,13
Enero,Santa Rosa,817,386,431,13
Enero,Sololá,819,427,392,13
Enero,Totonicapán,1015,502,513,13
Enero,Quetzaltenango,1710,857,853,13
Enero,Suchitepéquez,1304,665,639,13
Enero,Retalhuleu,660,329,331,13
Enero,San Marcos,2576,1294,1282,13
Enero,Huehuetenango,3356,1681,1675,13
Enero,Quiché,2684,1346,1338,13
Enero,Baja Verapaz,644,325,319,13
Enero,Alta Verapaz,2937,1424,1513,13
Enero,Petén,1229,649,580,13
Enero,Izabal,860,408,452,13
Enero,Zacapa,516,276,240,13
Enero,Chiquimula,979,478,501,13
Enero,Jalapa,822,425,397,13
Enero,Jutiapa,1048,511,537,13
Enero,Extranjero,6,1,5,13
Enero,Ignorado,5,1,4,13
Febrero,Todos los departamentos,29017,14639,14378,13
Febrero,Guatemala,5036,2590,2446,13
Febrero,El Progreso,323,174,149,13
Febrero,Sacatepéquez,528,261,267,13
Febrero,Chimaltenango,1141,601,540,13
Febrero,Escuintla,1213,608,605,13
Febrero,Santa Rosa,712,367,345,13
Febrero,Sololá,743,377,366,13
Febrero,Totonicapán,949,482,467,13
Febrero,Quetzaltenango,1594,818,776,13
Febrero,Suchitepéquez,989,513,476,13
Febrero,Retalhuleu,557,261,296,13
Febrero,San Marcos,2216,1090,1126,13
Febrero,Huehuetenango,2935,1424,1511,13
Febrero,Quiché,2402,1261,1141,13
Febrero,Baja Verapaz,627,327,300,13
Febrero,Alta Verapaz,2342,1144,1198,13
Febrero,Petén,1081,519,562,13
Febrero,Izabal,713,344,369,13
Febrero,Zacapa,420,205,215,13
Febrero,Chiquimula,850,439,411,13
Febrero,Jalapa,709,368,341,13
Febrero,Jutiapa,915,450,465,13
Febrero,Extranjero,22,16,6,13
Febrero,Ignorado,0,0,0,13
Marzo,Todos los departamentos,31019,15694,15325,13
Marzo,Guatemala,5466,2739,2727,13
Marzo,El Progreso,307,172,135,13
Marzo,Sacatepéquez,564,258,306,13
Marzo,Chimaltenango,1359,689,670,13
Marzo,Escuintla,1260,631,629,13
Marzo,Santa Rosa,759,388,371,13
Marzo,Sololá,869,455,414,13
Marzo,Totonicapán,946,485,461,13
Marzo,Quetzaltenango,1675,845,830,13
Marzo,Suchitepéquez,1100,567,533,13
Marzo,Retalhuleu,662,317,345,13
Marzo,San Marcos,2442,1232,1210,13
Marzo,Huehuetenango,2990,1500,1490,13
Marzo,Quiché,2368,1241,1127,13
Marzo,Baja Verapaz,621,315,306,13
Marzo,Alta Verapaz,2572,1339,1233,13
Marzo,Petén,1195,587,608,13
Marzo,Izabal,754,374,380,13
Marzo,Zacapa,489,252,237,13
Marzo,Chiquimula,899,470,429,13
Marzo,Jalapa,722,349,373,13
Marzo,Jutiapa,980,479,501,13
Marzo,Extranjero,16,9,7,13
Marzo,Ignorado,4,1,3,13
Abril,Todos los departamentos,31252,15970,15282,13
Abril,Guatemala,5424,2738,2686,13
Abril,El Progreso,305,155,150,13
Abril,Sacatepéquez,605,298,307,13
Abril,Chimaltenango,1291,668,623,13
Abril,Escuintla,1342,720,622,13
Abril,Santa Rosa,780,396,384,13
Abril,Sololá,804,399,405,13
Abril,Totonicapán,1079,556,523,13
Abril,Quetzaltenango,1609,839,770,13
Abril,Suchitepéquez,1155,583,572,13
Abril,Retalhuleu,658,347,311,13
Abril,San Marcos,2502,1302,1200,13
Abril,Huehuetenango,2996,1474,1522,13
Abril,Quiché,2481,1274,1207,13
Abril,Baja Verapaz,659,345,314,13
Abril,Alta Verapaz,2633,1332,1301,13
Abril,Petén,1209,632,577,13
Abril,Izabal,751,401,350,13
Abril,Zacapa,489,240,249,13
Abril,Chiquimula,816,436,380,13
Abril,Jalapa,699,367,332,13
Abril,Jutiapa,950,458,492,13
Abril,Extranjero,11,7,4,13
Abril,Ignorado,4,3,1,13
Mayo,Todos los departamentos,32324,16378,15946,13
Mayo,Guatemala,5497,2765,2732,13
Mayo,El Progreso,380,197,183,13
Mayo,Sacatepéquez,584,309,275,13
Mayo,Chimaltenango,1375,674,701,13
Mayo,Escuintla,1374,685,689,13
Mayo,Santa Rosa,726,363,363,13
Mayo,Sololá,807,396,411,13
Mayo,Totonicapán,1072,535,537,13
Mayo,Quetzaltenango,1663,839,824,13
Mayo,Suchitepéquez,1101,556,545,13
Mayo,Retalhuleu,678,354,324,13
Mayo,San Marcos,2558,1315,1243,13
Mayo,Huehuetenango,3201,1595,1606,13
Mayo,Quiché,2529,1286,1243,13
Mayo,Baja Verapaz,665,340,325,13
Mayo,Alta Verapaz,2886,1475,1411,13
Mayo,Petén,1217,642,575,13
Mayo,Izabal,857,420,437,13
Mayo,Zacapa,519,285,234,13
Mayo,Chiquimula,909,475,434,13
Mayo,Jalapa,786,394,392,13
Mayo,Jutiapa,923,469,454,13
Mayo,Extranjero,14,7,7,13
Mayo,Ignorado,3,2,1,13
Junio,Todos los departamentos,31353,16022,15331,13
Junio,Guatemala,5374,2711,2663,13
Junio,El Progreso,357,180,177,13
Junio,Sacatepéquez,536,282,254,13
Junio,Chimaltenango,1210,622,588,13
Junio,Escuintla,1337,709,628,13
Junio,Santa Rosa,777,402,375,13
Junio,Sololá,832,438,394,13
Junio,Totonicapán,984,489,495,13
Junio,Quetzaltenango,1700,895,805,13
Junio,Suchitepéquez,1070,541,529,13
Junio,Retalhuleu,658,324,334,13
Junio,San Marcos,2401,1250,1151,13
Junio,Huehuetenango,3075,1542,1533,13
Junio,Quiché,2496,1256,1240,13
Junio,Baja Verapaz,649,364,285,13
Junio,Alta Verapaz,2705,1355,1350,13
Junio,Petén,1235,630,605,13
Junio,Izabal,852,463,389,13
Junio,Zacapa,470,247,223,13
Junio,Chiquimula,889,451,438,13
Junio,Jalapa,812,409,403,13
Junio,Jutiapa,911,452,459,13
Junio,Extranjero,20,8,12,13
Junio,Ignorado,3,2,1,13
Julio,Todos los departamentos,32919,16704,16215,13
Julio,Guatemala,5657,2890,2767,13
Julio,El Progreso,352,198,154,13
Julio,Sacatepéquez,622,346,276,13
Julio,Chimaltenango,1303,656,647,13
Julio,Escuintla,1424,718,706,13
Julio,Santa Rosa,802,373,429,13
Julio,Sololá,883,474,409,13
Julio,Totonicapán,1023,521,502,13
Julio,Quetzaltenango,1691,857,834,13
Julio,Suchitepéquez,1089,574,515,13
Julio,Retalhuleu,662,311,351,13
Julio,San Marcos,2508,1259,1249,13
Julio,Huehuetenango,3156,1574,1582,13
Julio,Quiché,2534,1325,1209,13
Julio,Baja Verapaz,666,363,303,13
Julio,Alta Verapaz,3007,1478,1529,13
Julio,Petén,1394,681,713,13
Julio,Izabal,935,486,449,13
Julio,Zacapa,498,235,263,13
Julio,Chiquimula,897,464,433,13
Julio,Jalapa,789,403,386,13
Julio,Jutiapa,997,507,490,13
Julio,Extranjero,22,8,14,13
Julio,Ignorado,8,3,5,13
Agosto,Todos los departamentos,33521,17079,16442,13
Agosto,Guatemala,5855,2968,2887,13
Agosto,El Progreso,374,175,199,13
Agosto,Sacatepéquez,595,288,307,13
Agosto,Chimaltenango,1306,675,631,13
Agosto,Escuintla,1491,752,739,13
Agosto,Santa Rosa,785,399,386,13
Agosto,Sololá,869,454,415,13
Agosto,Totonicapán,1059,552,507,13
Agosto,Quetzaltenango,1645,841,804,13
Agosto,Suchitepéquez,1225,664,561,13
Agosto,Retalhuleu,733,388,345,13
Agosto,San Marcos,2587,1315,1272,13
Agosto,Huehuetenango,3251,1655,1596,13
Agosto,Quiché,2320,1153,1167,13
Agosto,Baja Verapaz,707,342,365,13
Agosto,Alta Verapaz,2914,1516,1398,13
Agosto,Petén,1461,726,735,13
Agosto,Izabal,1005,525,480,13
Agosto,Zacapa,566,299,267,13
Agosto,Chiquimula,916,464,452,13
Agosto,Jalapa,826,411,415,13
Agosto,Jutiapa,1001,507,494,13
Agosto,Extranjero,27,9,18,13
Agosto,Ignorado,3,1,2,13
Septiembre,Todos los departamentos,34914,17568,17346,13
Septiembre,Guatemala,5906,2991,2915,13
Septiembre,El Progreso,391,225,166,13
Septiembre,Sacatepéquez,624,317,307,13
Septiembre,Chimaltenango,1393,732,661,13
Septiembre,Escuintla,1491,752,739,13
Septiembre,Santa Rosa,833,414,419,13
Septiembre,Sololá,930,453,477,13
Septiembre,Totonicapán,1102,522,580,13
Septiembre,Quetzaltenango,1822,934,888,13
Septiembre,Suchitepéquez,1278,618,660,13
Septiembre,Retalhuleu,692,351,341,13
Septiembre,San Marcos,2669,1325,1344,13
Septiembre,Huehuetenango,3335,1695,1640,13
Septiembre,Quiché,2421,1229,1192,13
Septiembre,Baja Verapaz,690,319,371,13
Septiembre,Alta Verapaz,3291,1669,1622,13
Septiembre,Petén,1491,759,732,13
Septiembre,Izabal,1017,491,526,13
Septiembre,Zacapa,622,325,297,13
Septiembre,Chiquimula,1004,495,509,13
Septiembre,Jalapa,849,433,416,13
Septiembre,Jutiapa,1035,509,526,13
Septiembre,Extranjero,25,10,15,13
Septiembre,Ignorado,3,0,3,13
Octubre,Todos los departamentos,33540,17080,16460,13
Octubre,Guatemala,5560,2879,2681,13
Octubre,El Progreso,353,189,164,13
Octubre,Sacatepéquez,644,322,322,13
Octubre,Chimaltenango,1416,706,710,13
Octubre,Escuintla,1544,823,721,13
Octubre,Santa Rosa,840,437,403,13
Octubre,Sololá,829,420,409,13
Octubre,Totonicapán,972,509,463,13
Octubre,Quetzaltenango,1715,859,856,13
Octubre,Suchitepéquez,1249,624,625,13
Octubre,Retalhuleu,763,400,363,13
Octubre,San Marcos,2620,1313,1307,13
Octubre,Huehuetenango,3184,1557,1627,13
Octubre,Quiché,2272,1147,1125,13
Octubre,Baja Verapaz,690,386,304,13
Octubre,Alta Verapaz,2964,1493,1471,13
Octubre,Petén,1440,745,695,13
Octubre,Izabal,928,440,488,13
Octubre,Zacapa,577,293,284,13
Octubre,Chiquimula,997,520,477,13
Octubre,Jalapa,897,454,443,13
Octubre,Jutiapa,1060,548,512,13
Octubre,Extranjero,22,15,7,13
Octubre,Ignorado,4,1,3,13
Noviembre,Todos los departamentos,31677,16082,15595,13
Noviembre,Guatemala,5179,2648,2531,13
Noviembre,El Progreso,360,166,194,13
Noviembre,Sacatepéquez,531,245,286,13
Noviembre,Chimaltenango,1306,668,638,13
Noviembre,Escuintla,1306,653,653,13
Noviembre,Santa Rosa,804,428,376,13
Noviembre,Sololá,826,411,415,13
Noviembre,Totonicapán,970,472,498,13
Noviembre,Quetzaltenango,1678,833,845,13
Noviembre,Suchitepéquez,1195,609,586,13
Noviembre,Retalhuleu,738,381,357,13
Noviembre,San Marcos,2527,1239,1288,13
Noviembre,Huehuetenango,3024,1562,1462,13
Noviembre,Quiché,2324,1220,1104,13
Noviembre,Baja Verapaz,599,325,274,13
Noviembre,Alta Verapaz,2889,1469,1420,13
Noviembre,Petén,1272,648,624,13
Noviembre,Izabal,873,424,449,13
Noviembre,Zacapa,475,235,240,13
Noviembre,Chiquimula,921,479,442,13
Noviembre,Jalapa,847,438,409,13
Noviembre,Jutiapa,1019,523,496,13
Noviembre,Extranjero,13,6,7,13
Noviembre,Ignorado,1,0,1,13
Diciembre,Todos los departamentos,32676,16515,16161,13
Diciembre,Guatemala,5361,2688,2673,13
Diciembre,El Progreso,384,173,211,13
Diciembre,Sacatepéquez,590,305,285,13
Diciembre,Chimaltenango,1347,652,695,13
Diciembre,Escuintla,1286,646,640,13
Diciembre,Santa Rosa,843,451,392,13
Diciembre,Sololá,840,422,418,13
Diciembre,Totonicapán,1068,526,542,13
Diciembre,Quetzaltenango,1763,874,889,13
Diciembre,Suchitepéquez,1165,581,584,13
Diciembre,Retalhuleu,697,335,362,13
Diciembre,San Marcos,2587,1351,1236,13
Diciembre,Huehuetenango,3229,1692,1537,13
Diciembre,Quiché,2528,1292,1236,13
Diciembre,Baja Verapaz,672,355,317,13
Diciembre,Alta Verapaz,2979,1464,1515,13
Diciembre,Petén,1286,651,635,13
Diciembre,Izabal,859,447,412,13
Diciembre,Zacapa,491,243,248,13
Diciembre,Chiquimula,877,452,425,13
Diciembre,Jalapa,798,405,393,13
Diciembre,Jutiapa,997,496,501,13
Diciembre,Extranjero,27,14,13,13
Diciembre,Ignorado,2,0,2,13
Todos los meses,Todos los departamentos,386195,196685,189510,14
Todos los meses,Guatemala,66836,34041,32795,14
Todos los meses,El Progreso,4238,2148,2090,14
Todos los meses,Sacatepéquez,6965,3583,3382,14
Todos los meses,Chimaltenango,15685,7958,7727,14
Todos los meses,Escuintla,16976,8694,8282,14
Todos los meses,Santa Rosa,9168,4653,4515,14
Todos los meses,Sololá,10033,5107,4926,14
Todos los meses,Totonicapán,12200,6202,5998,14
Todos los meses,Quetzaltenango,20518,10388,10130,14
Todos los meses,Suchitepéquez,13885,7124,6761,14
Todos los meses,Retalhuleu,8321,4267,4054,14
Todos los meses,San Marcos,30366,15441,14925,14
Todos los meses,Huehuetenango,37843,19254,18589,14
Todos los meses,Quiché,28993,14689,14304,14
Todos los meses,Baja Verapaz,7941,4128,3813,14
Todos los meses,Alta Verapaz,33111,16859,16252,14
Todos los meses,Petén,15377,7862,7515,14
Todos los meses,Izabal,10140,5119,5021,14
Todos los meses,Zacapa,5984,3151,2833,14
Todos los meses,Chiquimula,10770,5470,5300,14
Todos los meses,Jalapa,9448,4773,4675,14
Todos los meses,Jutiapa,11186,5659,5527,14
Todos los meses,Extranjero,155,85,70,14
Todos los meses,Ignorado,56,30,26,14
Enero,Todos los departamentos,32492,16499,15993,14
Enero,Guatemala,5677,2857,2820,14
Enero,El Progreso,325,179,146,14
Enero,Sacatepéquez,543,270,273,14
Enero,Chimaltenango,1353,703,650,14
Enero,Escuintla,1300,679,621,14
Enero,Santa Rosa,779,401,378,14
Enero,Sololá,902,461,441,14
Enero,Totonicapán,1009,516,493,14
Enero,Quetzaltenango,1689,889,800,14
Enero,Suchitepéquez,1179,590,589,14
Enero,Retalhuleu,727,393,334,14
Enero,San Marcos,2624,1318,1306,14
Enero,Huehuetenango,3313,1660,1653,14
Enero,Quiché,2518,1273,1245,14
Enero,Baja Verapaz,698,362,336,14
Enero,Alta Verapaz,2745,1374,1371,14
Enero,Petén,1119,559,560,14
Enero,Izabal,800,400,400,14
Enero,Zacapa,456,233,223,14
Enero,Chiquimula,1005,502,503,14
Enero,Jalapa,793,418,375,14
Enero,Jutiapa,909,448,461,14
Enero,Extranjero,25,12,13,14
Enero,Ignorado,4,2,2,14
Febrero,Todos los departamentos,29074,14793,14281,14
Febrero,Guatemala,5151,2655,2496,14
Febrero,El Progreso,301,166,135,14
Febrero,Sacatepéquez,519,263,256,14
Febrero,Chimaltenango,1204,616,588,14
Febrero,Escuintla,1224,619,605,14
Febrero,Santa Rosa,676,338,338,14
Febrero,Sololá,807,408,399,14
Febrero,Totonicapán,931,454,477,14
Febrero,Quetzaltenango,1465,760,705,14
Febrero,Suchitepéquez,1045,517,528,14
Febrero,Retalhuleu,642,322,320,14
Febrero,San Marcos,2231,1119,1112,14
Febrero,Huehuetenango,2863,1488,1375,14
Febrero,Quiché,2413,1236,1177,14
Febrero,Baja Verapaz,652,328,324,14
Febrero,Alta Verapaz,2399,1201,1198,14
Febrero,Petén,1106,558,548,14
Febrero,Izabal,632,343,289,14
Febrero,Zacapa,409,219,190,14
Febrero,Chiquimula,850,425,425,14
Febrero,Jalapa,696,327,369,14
Febrero,Jutiapa,839,419,420,14
Febrero,Extranjero,14,9,5,14
Febrero,Ignorado,5,3,2,14
Marzo,Todos los departamentos,32092,16373,15719,14
Marzo,Guatemala,5585,2896,2689,14
Marzo,El Progreso,358,184,174,14
Marzo,Sacatepéquez,615,333,282,14
Marzo,Chimaltenango,1350,685,665,14
Marzo,Escuintla,1320,661,659,14
Marzo,Santa Rosa,714,363,351,14
Marzo,Sololá,853,432,421,14
Marzo,Totonicapán,1074,574,500,14
Marzo,Quetzaltenango,1680,822,858,14
Marzo,Suchitepéquez,1211,630,581,14
Marzo,Retalhuleu,682,350,332,14
Marzo,San Marcos,2544,1246,1298,14
Marzo,Huehuetenango,2993,1527,1466,14
Marzo,Quiché,2580,1319,1261,14
Marzo,Baja Verapaz,711,376,335,14
Marzo,Alta Verapaz,2610,1356,1254,14
Marzo,Petén,1299,640,659,14
Marzo,Izabal,798,412,386,14
Marzo,Zacapa,470,247,223,14
Marzo,Chiquimula,889,439,450,14
Marzo,Jalapa,824,404,420,14
Marzo,Jutiapa,914,466,448,14
Marzo,Extranjero,15,9,6,14
Marzo,Ignorado,3,2,1,14
Abril,Todos los departamentos,30966,15679,15287,14
Abril,Guatemala,5578,2822,2756,14
Abril,El Progreso,368,193,175,14
Abril,Sacatepéquez,500,266,234,14
Abril,Chimaltenango,1220,624,596,14
Abril,Escuintla,1384,701,683,14
Abril,Santa Rosa,700,347,353,14
Abril,Sololá,774,385,389,14
Abril,Totonicapán,996,503,493,14
Abril,Quetzaltenango,1535,759,776,14
Abril,Suchitepéquez,1131,564,567,14
Abril,Retalhuleu,654,335,319,14
Abril,San Marcos,2449,1271,1178,14
Abril,Huehuetenango,3044,1539,1505,14
Abril,Quiché,2408,1213,1195,14
Abril,Baja Verapaz,646,341,305,14
Abril,Alta Verapaz,2625,1315,1310,14
Abril,Petén,1243,624,619,14
Abril,Izabal,829,411,418,14
Abril,Zacapa,490,267,223,14
Abril,Chiquimula,822,420,402,14
Abril,Jalapa,692,332,360,14
Abril,Jutiapa,862,439,423,14
Abril,Extranjero,12,8,4,14
Abril,Ignorado,4,0,4,14
Mayo,Todos los departamentos,32460,16616,15844,14
Mayo,Guatemala,5575,2803,2772,14
Mayo,El Progreso,336,168,168,14
Mayo,Sacatepéquez,555,287,268,14
Mayo,Chimaltenango,1280,604,676,14
Mayo,Escuintla,1466,749,717,14
Mayo,Santa Rosa,782,406,376,14
Mayo,Sololá,868,448,420,14
Mayo,Totonicapán,1012,500,512,14
Mayo,Quetzaltenango,1723,891,832,14
Mayo,Suchitepéquez,1185,653,532,14
Mayo,Retalhuleu,686,350,336,14
Mayo,San Marcos,2489,1245,1244,14
Mayo,Huehuetenango,3193,1634,1559,14
Mayo,Quiché,2580,1322,1258,14
Mayo,Baja Verapaz,663,353,310,14
Mayo,Alta Verapaz,2791,1424,1367,14
Mayo,Petén,1265,696,569,14
Mayo,Izabal,818,403,415,14
Mayo,Zacapa,469,251,218,14
Mayo,Chiquimula,963,511,452,14
Mayo,Jalapa,808,414,394,14
Mayo,Jutiapa,937,494,443,14
Mayo,Extranjero,13,8,5,14
Mayo,Ignorado,3,2,1,14
Junio,Todos los departamentos,30906,15675,15231,14
Junio,Guatemala,5313,2636,2677,14
Junio,El Progreso,324,154,170,14
Junio,Sacatepéquez,557,279,278,14
Junio,Chimaltenango,1282,685,597,14
Junio,Escuintla,1390,726,664,14
Junio,Santa Rosa,729,381,348,14
Junio,Sololá,803,408,395,14
Junio,Totonicapán,1005,493,512,14
Junio,Quetzaltenango,1629,823,806,14
Junio,Suchitepéquez,1146,590,556,14
Junio,Retalhuleu,709,360,349,14
Junio,San Marcos,2341,1206,1135,14
Junio,Huehuetenango,3062,1527,1535,14
Junio,Quiché,2423,1206,1217,14
Junio,Baja Verapaz,628,305,323,14
Junio,Alta Verapaz,2634,1374,1260,14
Junio,Petén,1245,646,599,14
Junio,Izabal,731,363,368,14
Junio,Zacapa,479,256,223,14
Junio,Chiquimula,867,435,432,14
Junio,Jalapa,723,373,350,14
Junio,Jutiapa,869,440,429,14
Junio,Extranjero,9,5,4,14
Junio,Ignorado,8,4,4,14
Julio,Todos los departamentos,31793,16260,15533,14
Julio,Guatemala,5658,2920,2738,14
Julio,El Progreso,328,164,164,14
Julio,Sacatepéquez,579,308,271,14
Julio,Chimaltenango,1299,663,636,14
Julio,Escuintla,1443,758,685,14
Julio,Santa Rosa,751,370,381,14
Julio,Sololá,863,465,398,14
Julio,Totonicapán,1013,502,511,14
Julio,Quetzaltenango,1682,846,836,14
Julio,Suchitepéquez,1108,555,553,14
Julio,Retalhuleu,653,343,310,14
Julio,San Marcos,2456,1226,1230,14
Julio,Huehuetenango,3168,1623,1545,14
Julio,Quiché,2387,1191,1196,14
Julio,Baja Verapaz,660,359,301,14
Julio,Alta Verapaz,2627,1345,1282,14
Julio,Petén,1235,644,591,14
Julio,Izabal,856,415,441,14
Julio,Zacapa,494,258,236,14
Julio,Chiquimula,807,428,379,14
Julio,Jalapa,744,395,349,14
Julio,Jutiapa,966,472,494,14
Julio,Extranjero,12,8,4,14
Julio,Ignorado,4,2,2,14
Agosto,Todos los departamentos,31793,16224,15569,14
Agosto,Guatemala,5586,2822,2764,14
Agosto,El Progreso,358,183,175,14
Agosto,Sacatepéquez,582,322,260,14
Agosto,Chimaltenango,1380,711,669,14
Agosto,Escuintla,1459,767,692,14
Agosto,Santa Rosa,753,394,359,14
Agosto,Sololá,814,413,401,14
Agosto,Totonicapán,991,488,503,14
Agosto,Quetzaltenango,1710,877,833,14
Agosto,Suchitepéquez,1143,555,588,14
Agosto,Retalhuleu,670,349,321,14
Agosto,San Marcos,2534,1287,1247,14
Agosto,Huehuetenango,3082,1588,1494,14
Agosto,Quiché,2136,1065,1071,14
Agosto,Baja Verapaz,618,333,285,14
Agosto,Alta Verapaz,2745,1419,1326,14
Agosto,Petén,1350,680,670,14
Agosto,Izabal,912,466,446,14
Agosto,Zacapa,490,271,219,14
Agosto,Chiquimula,825,394,431,14
Agosto,Jalapa,735,371,364,14
Agosto,Jutiapa,904,460,444,14
Agosto,Extranjero,9,6,3,14
Agosto,Ignorado,7,3,4,14
Septiembre,Todos los departamentos,34533,17588,16945,14
Septiembre,Guatemala,5814,2940,2874,14
Septiembre,El Progreso,408,196,212,14
Septiembre,Sacatepéquez,663,341,322,14
Septiembre,Chimaltenango,1430,705,725,14
Septiembre,Escuintla,1531,769,762,14
Septiembre,Santa Rosa,829,422,407,14
Septiembre,Sololá,880,442,438,14
Septiembre,Totonicapán,1119,583,536,14
Septiembre,Quetzaltenango,1904,940,964,14
Septiembre,Suchitepéquez,1247,662,585,14
Septiembre,Retalhuleu,664,348,316,14
Septiembre,San Marcos,2744,1387,1357,14
Septiembre,Huehuetenango,3213,1638,1575,14
Septiembre,Quiché,2409,1205,1204,14
Septiembre,Baja Verapaz,681,361,320,14
Septiembre,Alta Verapaz,3093,1584,1509,14
Septiembre,Petén,1497,790,707,14
Septiembre,Izabal,1019,526,493,14
Septiembre,Zacapa,546,268,278,14
Septiembre,Chiquimula,962,508,454,14
Septiembre,Jalapa,842,441,401,14
Septiembre,Jutiapa,1018,520,498,14
Septiembre,Extranjero,16,8,8,14
Septiembre,Ignorado,4,4,0,14
Octubre,Todos los departamentos,34513,17439,17074,14
Octubre,Guatemala,5825,2947,2878,14
Octubre,El Progreso,399,193,206,14
Octubre,Sacatepéquez,600,316,284,14
Octubre,Chimaltenango,1293,653,640,14
Octubre,Escuintla,1562,801,761,14
Octubre,Santa Rosa,900,449,451,14
Octubre,Sololá,848,425,423,14
Octubre,Totonicapán,1065,550,515,14
Octubre,Quetzaltenango,1864,953,911,14
Octubre,Suchitepéquez,1254,649,605,14
Octubre,Retalhuleu,775,364,411,14
Octubre,San Marcos,2789,1436,1353,14
Octubre,Huehuetenango,3364,1704,1660,14
Octubre,Quiché,2505,1301,1204,14
Octubre,Baja Verapaz,626,308,318,14
Octubre,Alta Verapaz,2989,1488,1501,14
Octubre,Petén,1430,693,737,14
Octubre,Izabal,975,477,498,14
Octubre,Zacapa,611,308,303,14
Octubre,Chiquimula,927,471,456,14
Octubre,Jalapa,882,432,450,14
Octubre,Jutiapa,1010,510,500,14
Octubre,Extranjero,14,7,7,14
Octubre,Ignorado,6,4,2,14
Noviembre,Todos los departamentos,33040,16849,16191,14
Noviembre,Guatemala,5463,2804,2659,14
Noviembre,El Progreso,344,174,170,14
Noviembre,Sacatepéquez,634,314,320,14
Noviembre,Chimaltenango,1376,684,692,14
Noviembre,Escuintla,1507,747,760,14
Noviembre,Santa Rosa,786,395,391,14
Noviembre,Sololá,788,414,374,14
Noviembre,Totonicapán,1016,530,486,14
Noviembre,Quetzaltenango,1824,939,885,14
Noviembre,Suchitepéquez,1141,583,558,14
Noviembre,Retalhuleu,791,392,399,14
Noviembre,San Marcos,2565,1358,1207,14
Noviembre,Huehuetenango,3236,1668,1568,14
Noviembre,Quiché,2326,1159,1167,14
Noviembre,Baja Verapaz,652,340,312,14
Noviembre,Alta Verapaz,2953,1483,1470,14
Noviembre,Petén,1365,688,677,14
Noviembre,Izabal,919,474,445,14
Noviembre,Zacapa,576,310,266,14
Noviembre,Chiquimula,920,465,455,14
Noviembre,Jalapa,841,423,418,14
Noviembre,Jutiapa,1003,500,503,14
Noviembre,Extranjero,8,2,6,14
Noviembre,Ignorado,6,3,3,14
Diciembre,Todos los departamentos,32533,16690,15843,14
Diciembre,Guatemala,5611,2939,2672,14
Diciembre,El Progreso,389,194,195,14
Diciembre,Sacatepéquez,618,284,334,14
Diciembre,Chimaltenango,1218,625,593,14
Diciembre,Escuintla,1390,717,673,14
Diciembre,Santa Rosa,769,387,382,14
Diciembre,Sololá,833,406,427,14
Diciembre,Totonicapán,969,509,460,14
Diciembre,Quetzaltenango,1813,889,924,14
Diciembre,Suchitepéquez,1095,576,519,14
Diciembre,Retalhuleu,668,361,307,14
Diciembre,San Marcos,2600,1342,1258,14
Diciembre,Huehuetenango,3312,1658,1654,14
Diciembre,Quiché,2308,1199,1109,14
Diciembre,Baja Verapaz,706,362,344,14
Diciembre,Alta Verapaz,2900,1496,1404,14
Diciembre,Petén,1223,644,579,14
Diciembre,Izabal,851,429,422,14
Diciembre,Zacapa,494,263,231,14
Diciembre,Chiquimula,933,472,461,14
Diciembre,Jalapa,868,443,425,14
Diciembre,Jutiapa,955,491,464,14
Diciembre,Extranjero,8,3,5,14
Diciembre,Ignorado,2,1,1,14
Todos los meses,Todos los departamentos,391425,198750,192675,15
Todos los meses,Guatemala,67471,34204,33267,15
Todos los meses,El Progreso,4057,2098,1959,15
Todos los meses,Sacatepéquez,7292,3663,3629,15
Todos los meses,Chimaltenango,16042,8125,7917,15
Todos los meses,Escuintla,16830,8533,8297,15
Todos los meses,Santa Rosa,8834,4400,4434,15
Todos los meses,Sololá,10507,5383,5124,15
Todos los meses,Totonicapán,12443,6390,6053,15
Todos los meses,Quetzaltenango,20838,10497,10341,15
Todos los meses,Suchitepéquez,13818,7132,6686,15
Todos los meses,Retalhuleu,8510,4360,4150,15
Todos los meses,San Marcos,30832,15745,15087,15
Todos los meses,Huehuetenango,38669,19613,19056,15
Todos los meses,Quiché,29490,14967,14523,15
Todos los meses,Baja Verapaz,7953,4128,3825,15
Todos los meses,Alta Verapaz,34605,17513,17092,15
Todos los meses,Petén,15111,7588,7523,15
Todos los meses,Izabal,10326,5205,5121,15
Todos los meses,Zacapa,6115,3075,3040,15
Todos los meses,Chiquimula,10967,5520,5447,15
Todos los meses,Jalapa,9340,4779,4561,15
Todos los meses,Jutiapa,11239,5759,5480,15
Todos los meses,Extranjero,107,63,44,15
Todos los meses,Ignorado,29,10,19,15
Enero,Todos los departamentos,33495,17029,16466,15
Enero,Guatemala,5619,2877,2742,15
Enero,El Progreso,360,173,187,15
Enero,Sacatepéquez,651,356,295,15
Enero,Chimaltenango,1365,664,701,15
Enero,Escuintla,1355,682,673,15
Enero,Santa Rosa,802,388,414,15
Enero,Sololá,898,452,446,15
Enero,Totonicapán,1047,550,497,15
Enero,Quetzaltenango,1805,910,895,15
Enero,Suchitepéquez,1185,606,579,15
Enero,Retalhuleu,681,345,336,15
Enero,San Marcos,2730,1398,1332,15
Enero,Huehuetenango,3464,1758,1706,15
Enero,Quiché,2612,1315,1297,15
Enero,Baja Verapaz,647,349,298,15
Enero,Alta Verapaz,2880,1432,1448,15
Enero,Petén,1191,599,592,15
Enero,Izabal,864,440,424,15
Enero,Zacapa,510,258,252,15
Enero,Chiquimula,947,483,464,15
Enero,Jalapa,832,441,391,15
Enero,Jutiapa,1032,548,484,15
Enero,Extranjero,12,4,8,15
Enero,Ignorado,6,1,5,15
Febrero,Todos los departamentos,29402,14866,14536,15
Febrero,Guatemala,5108,2569,2539,15
Febrero,El Progreso,275,137,138,15
Febrero,Sacatepéquez,564,294,270,15
Febrero,Chimaltenango,1184,583,601,15
Febrero,Escuintla,1240,646,594,15
Febrero,Santa Rosa,698,362,336,15
Febrero,Sololá,821,418,403,15
Febrero,Totonicapán,990,504,486,15
Febrero,Quetzaltenango,1579,834,745,15
Febrero,Suchitepéquez,1000,490,510,15
Febrero,Retalhuleu,607,324,283,15
Febrero,San Marcos,2294,1164,1130,15
Febrero,Huehuetenango,2848,1435,1413,15
Febrero,Quiché,2339,1140,1199,15
Febrero,Baja Verapaz,646,353,293,15
Febrero,Alta Verapaz,2556,1313,1243,15
Febrero,Petén,1077,524,553,15
Febrero,Izabal,727,370,357,15
Febrero,Zacapa,478,234,244,15
Febrero,Chiquimula,813,410,403,15
Febrero,Jalapa,704,329,375,15
Febrero,Jutiapa,843,427,416,15
Febrero,Extranjero,8,4,4,15
Febrero,Ignorado,3,2,1,15
Marzo,Todos los departamentos,32419,16483,15936,15
Marzo,Guatemala,5847,3023,2824,15
Marzo,El Progreso,353,184,169,15
Marzo,Sacatepéquez,618,287,331,15
Marzo,Chimaltenango,1341,701,640,15
Marzo,Escuintla,1410,743,667,15
Marzo,Santa Rosa,775,370,405,15
Marzo,Sololá,813,415,398,15
Marzo,Totonicapán,995,519,476,15
Marzo,Quetzaltenango,1695,870,825,15
Marzo,Suchitepéquez,1162,596,566,15
Marzo,Retalhuleu,723,359,364,15
Marzo,San Marcos,2586,1308,1278,15
Marzo,Huehuetenango,3064,1530,1534,15
Marzo,Quiché,2590,1293,1297,15
Marzo,Baja Verapaz,718,376,342,15
Marzo,Alta Verapaz,2684,1360,1324,15
Marzo,Petén,1248,635,613,15
Marzo,Izabal,757,370,387,15
Marzo,Zacapa,492,244,248,15
Marzo,Chiquimula,849,420,429,15
Marzo,Jalapa,797,406,391,15
Marzo,Jutiapa,888,467,421,15
Marzo,Extranjero,11,5,6,15
Marzo,Ignorado,3,2,1,15
Abril,Todos los departamentos,30765,15811,14954,15
Abril,Guatemala,5458,2772,2686,15
Abril,El Progreso,299,144,155,15
Abril,Sacatepéquez,584,274,310,15
Abril,Chimaltenango,1248,655,593,15
Abril,Escuintla,1254,614,640,15
Abril,Santa Rosa,685,369,316,15
Abril,Sololá,849,444,405,15
Abril,Totonicapán,978,524,454,15
Abril,Quetzaltenango,1684,879,805,15
Abril,Suchitepéquez,1135,577,558,15
Abril,Retalhuleu,653,328,325,15
Abril,San Marcos,2411,1254,1157,15
Abril,Huehuetenango,2929,1539,1390,15
Abril,Quiché,2439,1209,1230,15
Abril,Baja Verapaz,662,347,315,15
Abril,Alta Verapaz,2676,1388,1288,15
Abril,Petén,1168,588,580,15
Abril,Izabal,771,402,369,15
Abril,Zacapa,443,230,213,15
Abril,Chiquimula,834,452,382,15
Abril,Jalapa,755,383,372,15
Abril,Jutiapa,833,428,405,15
Abril,Extranjero,14,10,4,15
Abril,Ignorado,3,1,2,15
Mayo,Todos los departamentos,32095,16216,15879,15
Mayo,Guatemala,5695,2876,2819,15
Mayo,El Progreso,308,163,145,15
Mayo,Sacatepéquez,598,297,301,15
Mayo,Chimaltenango,1363,682,681,15
Mayo,Escuintla,1391,667,724,15
Mayo,Santa Rosa,698,343,355,15
Mayo,Sololá,939,481,458,15
Mayo,Totonicapán,1046,536,510,15
Mayo,Quetzaltenango,1709,867,842,15
Mayo,Suchitepéquez,1108,578,530,15
Mayo,Retalhuleu,708,378,330,15
Mayo,San Marcos,2451,1242,1209,15
Mayo,Huehuetenango,3116,1595,1521,15
Mayo,Quiché,2628,1345,1283,15
Mayo,Baja Verapaz,588,301,287,15
Mayo,Alta Verapaz,2740,1346,1394,15
Mayo,Petén,1229,615,614,15
Mayo,Izabal,808,375,433,15
Mayo,Zacapa,477,233,244,15
Mayo,Chiquimula,844,421,423,15
Mayo,Jalapa,726,386,340,15
Mayo,Jutiapa,918,484,434,15
Mayo,Extranjero,6,4,2,15
Mayo,Ignorado,1,1,0,15
Junio,Todos los departamentos,31221,15849,15372,15
Junio,Guatemala,5518,2844,2674,15
Junio,El Progreso,309,164,145,15
Junio,Sacatepéquez,562,283,279,15
Junio,Chimaltenango,1281,658,623,15
Junio,Escuintla,1346,693,653,15
Junio,Santa Rosa,630,309,321,15
Junio,Sololá,864,445,419,15
Junio,Totonicapán,919,457,462,15
Junio,Quetzaltenango,1735,879,856,15
Junio,Suchitepéquez,1153,599,554,15
Junio,Retalhuleu,708,348,360,15
Junio,San Marcos,2452,1252,1200,15
Junio,Huehuetenango,3076,1569,1507,15
Junio,Quiché,2322,1103,1219,15
Junio,Baja Verapaz,636,320,316,15
Junio,Alta Verapaz,2754,1421,1333,15
Junio,Petén,1126,552,574,15
Junio,Izabal,807,437,370,15
Junio,Zacapa,495,275,220,15
Junio,Chiquimula,854,413,441,15
Junio,Jalapa,731,376,355,15
Junio,Jutiapa,929,441,488,15
Junio,Extranjero,13,10,3,15
Junio,Ignorado,1,1,0,15
Julio,Todos los departamentos,32613,16578,16035,15
Julio,Guatemala,5743,2916,2827,15
Julio,El Progreso,345,186,159,15
Julio,Sacatepéquez,631,314,317,15
Julio,Chimaltenango,1367,705,662,15
Julio,Escuintla,1345,670,675,15
Julio,Santa Rosa,750,373,377,15
Julio,Sololá,878,429,449,15
Julio,Totonicapán,1090,552,538,15
Julio,Quetzaltenango,1737,858,879,15
Julio,Suchitepéquez,1199,626,573,15
Julio,Retalhuleu,687,356,331,15
Julio,San Marcos,2571,1328,1243,15
Julio,Huehuetenango,3210,1620,1590,15
Julio,Quiché,2396,1269,1127,15
Julio,Baja Verapaz,677,331,346,15
Julio,Alta Verapaz,2777,1420,1357,15
Julio,Petén,1178,610,568,15
Julio,Izabal,943,466,477,15
Julio,Zacapa,507,245,262,15
Julio,Chiquimula,896,449,447,15
Julio,Jalapa,750,383,367,15
Julio,Jutiapa,929,469,460,15
Julio,Extranjero,7,3,4,15
Julio,Ignorado,0,0,0,15
Agosto,Todos los departamentos,33238,16995,16243,15
Agosto,Guatemala,5877,2922,2955,15
Agosto,El Progreso,337,160,177,15
Agosto,Sacatepéquez,646,348,298,15
Agosto,Chimaltenango,1392,720,672,15
Agosto,Escuintla,1404,717,687,15
Agosto,Santa Rosa,737,361,376,15
Agosto,Sololá,901,466,435,15
Agosto,Totonicapán,1038,524,514,15
Agosto,Quetzaltenango,1716,864,852,15
Agosto,Suchitepéquez,1104,575,529,15
Agosto,Retalhuleu,751,394,357,15
Agosto,San Marcos,2671,1390,1281,15
Agosto,Huehuetenango,3360,1731,1629,15
Agosto,Quiché,2306,1221,1085,15
Agosto,Baja Verapaz,654,328,326,15
Agosto,Alta Verapaz,2981,1519,1462,15
Agosto,Petén,1366,706,660,15
Agosto,Izabal,942,476,466,15
Agosto,Zacapa,483,235,248,15
Agosto,Chiquimula,900,463,437,15
Agosto,Jalapa,717,373,344,15
Agosto,Jutiapa,944,493,451,15
Agosto,Extranjero,9,9,0,15
Agosto,Ignorado,2,0,2,15
Septiembre,Todos los departamentos,35320,17845,17475,15
Septiembre,Guatemala,5961,3069,2892,15
Septiembre,El Progreso,392,209,183,15
Septiembre,Sacatepéquez,635,310,325,15
Septiembre,Chimaltenango,1367,643,724,15
Septiembre,Escuintla,1550,784,766,15
Septiembre,Santa Rosa,814,399,415,15
Septiembre,Sololá,907,491,416,15
Septiembre,Totonicapán,1123,588,535,15
Septiembre,Quetzaltenango,1868,914,954,15
Septiembre,Suchitepéquez,1216,610,606,15
Septiembre,Retalhuleu,721,383,338,15
Septiembre,San Marcos,2731,1357,1374,15
Septiembre,Huehuetenango,3508,1795,1713,15
Septiembre,Quiché,2535,1262,1273,15
Septiembre,Baja Verapaz,687,356,331,15
Septiembre,Alta Verapaz,3315,1647,1668,15
Septiembre,Petén,1488,731,757,15
Septiembre,Izabal,1016,504,512,15
Septiembre,Zacapa,558,280,278,15
Septiembre,Chiquimula,1032,527,505,15
Septiembre,Jalapa,878,453,425,15
Septiembre,Jutiapa,1004,528,476,15
Septiembre,Extranjero,11,5,6,15
Septiembre,Ignorado,3,0,3,15
Octubre,Todos los departamentos,34429,17450,16979,15
Octubre,Guatemala,5706,2835,2871,15
Octubre,El Progreso,391,209,182,15
Octubre,Sacatepéquez,608,310,298,15
Octubre,Chimaltenango,1349,698,651,15
Octubre,Escuintla,1665,839,826,15
Octubre,Santa Rosa,782,383,399,15
Octubre,Sololá,861,429,432,15
Octubre,Totonicapán,1096,555,541,15
Octubre,Quetzaltenango,1823,887,936,15
Octubre,Suchitepéquez,1275,689,586,15
Octubre,Retalhuleu,733,365,368,15
Octubre,San Marcos,2646,1328,1318,15
Octubre,Huehuetenango,3366,1687,1679,15
Octubre,Quiché,2471,1286,1185,15
Octubre,Baja Verapaz,664,340,324,15
Octubre,Alta Verapaz,3177,1628,1549,15
Octubre,Petén,1412,729,683,15
Octubre,Izabal,964,507,457,15
Octubre,Zacapa,642,317,325,15
Octubre,Chiquimula,1009,510,499,15
Octubre,Jalapa,816,421,395,15
Octubre,Jutiapa,970,495,475,15
Octubre,Extranjero,3,3,0,15
Octubre,Ignorado,0,0,0,15
Noviembre,Todos los departamentos,32729,16400,16329,15
Noviembre,Guatemala,5291,2591,2700,15
Noviembre,El Progreso,359,205,154,15
Noviembre,Sacatepéquez,591,286,305,15
Noviembre,Chimaltenango,1366,685,681,15
Noviembre,Escuintla,1453,742,711,15
Noviembre,Santa Rosa,751,365,386,15
Noviembre,Sololá,839,436,403,15
Noviembre,Totonicapán,1044,531,513,15
Noviembre,Quetzaltenango,1683,814,869,15
Noviembre,Suchitepéquez,1092,575,517,15
Noviembre,Retalhuleu,750,381,369,15
Noviembre,San Marcos,2574,1330,1244,15
Noviembre,Huehuetenango,3307,1606,1701,15
Noviembre,Quiché,2367,1201,1166,15
Noviembre,Baja Verapaz,682,367,315,15
Noviembre,Alta Verapaz,3015,1499,1516,15
Noviembre,Petén,1355,676,679,15
Noviembre,Izabal,894,431,463,15
Noviembre,Zacapa,492,255,237,15
Noviembre,Chiquimula,982,490,492,15
Noviembre,Jalapa,832,421,411,15
Noviembre,Jutiapa,996,507,489,15
Noviembre,Extranjero,11,5,6,15
Noviembre,Ignorado,3,1,2,15
Diciembre,Todos los departamentos,33699,17228,16471,15
Diciembre,Guatemala,5648,2910,2738,15
Diciembre,El Progreso,329,164,165,15
Diciembre,Sacatepéquez,604,304,300,15
Diciembre,Chimaltenango,1419,731,688,15
Diciembre,Escuintla,1417,736,681,15
Diciembre,Santa Rosa,712,378,334,15
Diciembre,Sololá,937,477,460,15
Diciembre,Totonicapán,1077,550,527,15
Diciembre,Quetzaltenango,1804,921,883,15
Diciembre,Suchitepéquez,1189,611,578,15
Diciembre,Retalhuleu,788,399,389,15
Diciembre,San Marcos,2715,1394,1321,15
Diciembre,Huehuetenango,3421,1748,1673,15
Diciembre,Quiché,2485,1323,1162,15
Diciembre,Baja Verapaz,692,360,332,15
Diciembre,Alta Verapaz,3050,1540,1510,15
Diciembre,Petén,1273,623,650,15
Diciembre,Izabal,833,427,406,15
Diciembre,Zacapa,538,269,269,15
Diciembre,Chiquimula,1007,482,525,15
Diciembre,Jalapa,802,407,395,15
Diciembre,Jutiapa,953,472,481,15
Diciembre,Extranjero,2,1,1,15
Diciembre,Ignorado,4,1,3,15
Todos los meses,Todos los departamentos,390382,198516,191866,16
Todos los meses,Guatemala,67192,34362,32830,16
Todos los meses,El Progreso,4044,2090,1954,16
Todos los meses,Sacatepéquez,6734,3497,3237,16
Todos los meses,Chimaltenango,16563,8438,8125,16
Todos los meses,Escuintla,16266,8204,8062,16
Todos los meses,Santa Rosa,9063,4562,4501,16
Todos los meses,Sololá,10351,5241,5110,16
Todos los meses,Totonicapán,13113,6717,6396,16
Todos los meses,Quetzaltenango,20774,10620,10154,16
Todos los meses,Suchitepéquez,13349,6814,6535,16
Todos los meses,Retalhuleu,8144,4120,4024,16
Todos los meses,San Marcos,31880,16242,15638,16
Todos los meses,Huehuetenango,38078,19387,18691,16
Todos los meses,Quiché,29490,14875,14615,16
Todos los meses,Baja Verapaz,8187,4215,3972,16
Todos los meses,Alta Verapaz,34340,17280,17060,16
Todos los meses,Petén,15474,7877,7597,16
Todos los meses,Izabal,9800,4975,4825,16
Todos los meses,Zacapa,5443,2797,2646,16
Todos los meses,Chiquimula,11375,5738,5637,16
Todos los meses,Jalapa,9303,4750,4553,16
Todos los meses,Jutiapa,11246,5627,5619,16
Todos los meses,Extranjero,130,69,61,16
Todos los meses,Ignorado,43,19,24,16
Enero,Todos los departamentos,32299,16347,15952,16
Enero,Guatemala,5447,2812,2635,16
Enero,El Progreso,310,152,158,16
Enero,Sacatepéquez,563,282,281,16
Enero,Chimaltenango,1400,719,681,16
Enero,Escuintla,1317,638,679,16
Enero,Santa Rosa,726,362,364,16
Enero,Sololá,893,438,455,16
Enero,Totonicapán,1080,574,506,16
Enero,Quetzaltenango,1694,843,851,16
Enero,Suchitepéquez,1080,580,500,16
Enero,Retalhuleu,633,318,315,16
Enero,San Marcos,2702,1323,1379,16
Enero,Huehuetenango,3263,1609,1654,16
Enero,Quiché,2519,1307,1212,16
Enero,Baja Verapaz,676,367,309,16
Enero,Alta Verapaz,2829,1380,1449,16
Enero,Petén,1164,585,579,16
Enero,Izabal,790,411,379,16
Enero,Zacapa,459,243,216,16
Enero,Chiquimula,1048,540,508,16
Enero,Jalapa,843,425,418,16
Enero,Jutiapa,847,432,415,16
Enero,Extranjero,8,5,3,16
Enero,Ignorado,8,2,6,16
Febrero,Todos los departamentos,30738,15700,15038,16
Febrero,Guatemala,5264,2726,2538,16
Febrero,El Progreso,327,165,162,16
Febrero,Sacatepéquez,540,295,245,16
Febrero,Chimaltenango,1303,668,635,16
Febrero,Escuintla,1207,631,576,16
Febrero,Santa Rosa,787,391,396,16
Febrero,Sololá,833,415,418,16
Febrero,Totonicapán,1055,536,519,16
Febrero,Quetzaltenango,1694,856,838,16
Febrero,Suchitepéquez,973,507,466,16
Febrero,Retalhuleu,585,290,295,16
Febrero,San Marcos,2529,1290,1239,16
Febrero,Huehuetenango,2967,1511,1456,16
Febrero,Quiché,2609,1290,1319,16
Febrero,Baja Verapaz,685,346,339,16
Febrero,Alta Verapaz,2643,1348,1295,16
Febrero,Petén,991,529,462,16
Febrero,Izabal,697,360,337,16
Febrero,Zacapa,404,207,197,16
Febrero,Chiquimula,1036,516,520,16
Febrero,Jalapa,743,370,373,16
Febrero,Jutiapa,848,442,406,16
Febrero,Extranjero,11,6,5,16
Febrero,Ignorado,7,5,2,16
Marzo,Todos los departamentos,33616,17160,16456,16
Marzo,Guatemala,5574,2874,2700,16
Marzo,El Progreso,359,167,192,16
Marzo,Sacatepéquez,592,305,287,16
Marzo,Chimaltenango,1497,755,742,16
Marzo,Escuintla,1445,768,677,16
Marzo,Santa Rosa,780,386,394,16
Marzo,Sololá,839,450,389,16
Marzo,Totonicapán,1196,612,584,16
Marzo,Quetzaltenango,1811,937,874,16
Marzo,Suchitepéquez,1103,564,539,16
Marzo,Retalhuleu,685,332,353,16
Marzo,San Marcos,2848,1431,1417,16
Marzo,Huehuetenango,3265,1652,1613,16
Marzo,Quiché,2678,1345,1333,16
Marzo,Baja Verapaz,687,363,324,16
Marzo,Alta Verapaz,2821,1448,1373,16
Marzo,Petén,1306,662,644,16
Marzo,Izabal,801,417,384,16
Marzo,Zacapa,494,245,249,16
Marzo,Chiquimula,1121,563,558,16
Marzo,Jalapa,813,420,393,16
Marzo,Jutiapa,886,454,432,16
Marzo,Extranjero,12,7,5,16
Marzo,Ignorado,3,3,0,16
Abril,Todos los departamentos,32807,16688,16119,16
Abril,Guatemala,5446,2784,2662,16
Abril,El Progreso,320,161,159,16
Abril,Sacatepéquez,565,299,266,16
Abril,Chimaltenango,1454,740,714,16
Abril,Escuintla,1331,693,638,16
Abril,Santa Rosa,708,350,358,16
Abril,Sololá,832,415,417,16
Abril,Totonicapán,1131,573,558,16
Abril,Quetzaltenango,1761,930,831,16
Abril,Suchitepéquez,1052,520,532,16
Abril,Retalhuleu,684,365,319,16
Abril,San Marcos,2936,1498,1438,16
Abril,Huehuetenango,3238,1668,1570,16
Abril,Quiché,2639,1308,1331,16
Abril,Baja Verapaz,649,344,305,16
Abril,Alta Verapaz,2717,1377,1340,16
Abril,Petén,1375,699,676,16
Abril,Izabal,824,392,432,16
Abril,Zacapa,435,212,223,16
Abril,Chiquimula,1021,531,490,16
Abril,Jalapa,769,383,386,16
Abril,Jutiapa,911,442,469,16
Abril,Extranjero,5,4,1,16
Abril,Ignorado,4,0,4,16
Mayo,Todos los departamentos,34291,17437,16854,16
Mayo,Guatemala,5610,2812,2798,16
Mayo,El Progreso,372,197,175,16
Mayo,Sacatepéquez,610,308,302,16
Mayo,Chimaltenango,1431,722,709,16
Mayo,Escuintla,1461,716,745,16
Mayo,Santa Rosa,799,430,369,16
Mayo,Sololá,910,445,465,16
Mayo,Totonicapán,1152,585,567,16
Mayo,Quetzaltenango,1865,936,929,16
Mayo,Suchitepéquez,1192,602,590,16
Mayo,Retalhuleu,716,364,352,16
Mayo,San Marcos,3047,1545,1502,16
Mayo,Huehuetenango,3385,1717,1668,16
Mayo,Quiché,2627,1358,1269,16
Mayo,Baja Verapaz,698,367,331,16
Mayo,Alta Verapaz,2976,1530,1446,16
Mayo,Petén,1388,704,684,16
Mayo,Izabal,823,407,416,16
Mayo,Zacapa,449,241,208,16
Mayo,Chiquimula,1007,524,483,16
Mayo,Jalapa,850,443,407,16
Mayo,Jutiapa,915,482,433,16
Mayo,Extranjero,2,2,0,16
Mayo,Ignorado,6,0,6,16
Junio,Todos los departamentos,32461,16668,15793,16
Junio,Guatemala,5595,2846,2749,16
Junio,El Progreso,318,171,147,16
Junio,Sacatepéquez,566,291,275,16
Junio,Chimaltenango,1375,701,674,16
Junio,Escuintla,1382,684,698,16
Junio,Santa Rosa,779,388,391,16
Junio,Sololá,865,433,432,16
Junio,Totonicapán,1124,590,534,16
Junio,Quetzaltenango,1688,878,810,16
Junio,Suchitepéquez,1247,645,602,16
Junio,Retalhuleu,708,357,351,16
Junio,San Marcos,2682,1388,1294,16
Junio,Huehuetenango,3154,1641,1513,16
Junio,Quiché,2494,1317,1177,16
Junio,Baja Verapaz,709,351,358,16
Junio,Alta Verapaz,2692,1353,1339,16
Junio,Petén,1248,674,574,16
Junio,Izabal,803,425,378,16
Junio,Zacapa,445,240,205,16
Junio,Chiquimula,915,453,462,16
Junio,Jalapa,723,352,371,16
Junio,Jutiapa,940,485,455,16
Junio,Extranjero,8,5,3,16
Junio,Ignorado,1,0,1,16
Julio,Todos los departamentos,32313,16367,15946,16
Julio,Guatemala,5755,2955,2800,16
Julio,El Progreso,295,157,138,16
Julio,Sacatepéquez,536,295,241,16
Julio,Chimaltenango,1330,676,654,16
Julio,Escuintla,1365,709,656,16
Julio,Santa Rosa,712,335,377,16
Julio,Sololá,852,411,441,16
Julio,Totonicapán,1098,587,511,16
Julio,Quetzaltenango,1799,921,878,16
Julio,Suchitepéquez,1099,594,505,16
Julio,Retalhuleu,704,348,356,16
Julio,San Marcos,2687,1368,1319,16
Julio,Huehuetenango,3151,1588,1563,16
Julio,Quiché,2348,1188,1160,16
Julio,Baja Verapaz,717,369,348,16
Julio,Alta Verapaz,2810,1390,1420,16
Julio,Petén,1292,644,648,16
Julio,Izabal,818,378,440,16
Julio,Zacapa,431,213,218,16
Julio,Chiquimula,884,458,426,16
Julio,Jalapa,715,372,343,16
Julio,Jutiapa,894,402,492,16
Julio,Extranjero,18,9,9,16
Julio,Ignorado,3,0,3,16
Agosto,Todos los departamentos,32618,16520,16098,16
Agosto,Guatemala,5883,2983,2900,16
Agosto,El Progreso,328,174,154,16
Agosto,Sacatepéquez,560,298,262,16
Agosto,Chimaltenango,1390,695,695,16
Agosto,Escuintla,1351,670,681,16
Agosto,Santa Rosa,769,392,377,16
Agosto,Sololá,894,455,439,16
Agosto,Totonicapán,1131,562,569,16
Agosto,Quetzaltenango,1749,895,854,16
Agosto,Suchitepéquez,1154,578,576,16
Agosto,Retalhuleu,680,347,333,16
Agosto,San Marcos,2498,1258,1240,16
Agosto,Huehuetenango,3134,1664,1470,16
Agosto,Quiché,2252,1123,1129,16
Agosto,Baja Verapaz,699,366,333,16
Agosto,Alta Verapaz,2833,1405,1428,16
Agosto,Petén,1358,665,693,16
Agosto,Izabal,868,459,409,16
Agosto,Zacapa,459,238,221,16
Agosto,Chiquimula,825,376,449,16
Agosto,Jalapa,744,392,352,16
Agosto,Jutiapa,1043,515,528,16
Agosto,Extranjero,13,7,6,16
Agosto,Ignorado,3,3,0,16
Septiembre,Todos los departamentos,33990,17250,16740,16
Septiembre,Guatemala,5945,3051,2894,16
Septiembre,El Progreso,369,190,179,16
Septiembre,Sacatepéquez,589,295,294,16
Septiembre,Chimaltenango,1415,731,684,16
Septiembre,Escuintla,1354,651,703,16
Septiembre,Santa Rosa,808,422,386,16
Septiembre,Sololá,890,461,429,16
Septiembre,Totonicapán,1099,548,551,16
Septiembre,Quetzaltenango,1816,914,902,16
Septiembre,Suchitepéquez,1190,577,613,16
Septiembre,Retalhuleu,693,361,332,16
Septiembre,San Marcos,2629,1381,1248,16
Septiembre,Huehuetenango,3257,1630,1627,16
Septiembre,Quiché,2396,1200,1196,16
Septiembre,Baja Verapaz,691,342,349,16
Septiembre,Alta Verapaz,3255,1636,1619,16
Septiembre,Petén,1371,676,695,16
Septiembre,Izabal,924,483,441,16
Septiembre,Zacapa,502,271,231,16
Septiembre,Chiquimula,889,423,466,16
Septiembre,Jalapa,807,426,381,16
Septiembre,Jutiapa,1087,569,518,16
Septiembre,Extranjero,12,10,2,16
Septiembre,Ignorado,2,2,0,16
Octubre,Todos los departamentos,33026,16757,16269,16
Octubre,Guatemala,5702,2903,2799,16
Octubre,El Progreso,370,203,167,16
Octubre,Sacatepéquez,559,297,262,16
Octubre,Chimaltenango,1329,672,657,16
Octubre,Escuintla,1429,737,692,16
Octubre,Santa Rosa,737,373,364,16
Octubre,Sololá,849,434,415,16
Octubre,Totonicapán,1064,553,511,16
Octubre,Quetzaltenango,1725,875,850,16
Octubre,Suchitepéquez,1170,582,588,16
Octubre,Retalhuleu,716,355,361,16
Octubre,San Marcos,2512,1303,1209,16
Octubre,Huehuetenango,3177,1598,1579,16
Octubre,Quiché,2372,1121,1251,16
Octubre,Baja Verapaz,695,357,338,16
Octubre,Alta Verapaz,3071,1538,1533,16
Octubre,Petén,1446,760,686,16
Octubre,Izabal,851,424,427,16
Octubre,Zacapa,476,259,217,16
Octubre,Chiquimula,919,454,465,16
Octubre,Jalapa,802,431,371,16
Octubre,Jutiapa,1034,519,515,16
Octubre,Extranjero,19,7,12,16
Octubre,Ignorado,2,2,0,16
Noviembre,Todos los departamentos,31555,16028,15527,16
Noviembre,Guatemala,5607,2920,2687,16
Noviembre,El Progreso,355,185,170,16
Noviembre,Sacatepéquez,558,276,282,16
Noviembre,Chimaltenango,1298,645,653,16
Noviembre,Escuintla,1376,662,714,16
Noviembre,Santa Rosa,781,394,387,16
Noviembre,Sololá,868,455,413,16
Noviembre,Totonicapán,970,459,511,16
Noviembre,Quetzaltenango,1582,788,794,16
Noviembre,Suchitepéquez,1043,530,513,16
Noviembre,Retalhuleu,678,338,340,16
Noviembre,San Marcos,2419,1223,1196,16
Noviembre,Huehuetenango,2977,1527,1450,16
Noviembre,Quiché,2288,1171,1117,16
Noviembre,Baja Verapaz,615,299,316,16
Noviembre,Alta Verapaz,2894,1479,1415,16
Noviembre,Petén,1342,689,653,16
Noviembre,Izabal,876,477,399,16
Noviembre,Zacapa,471,235,236,16
Noviembre,Chiquimula,860,457,403,16
Noviembre,Jalapa,755,376,379,16
Noviembre,Jutiapa,930,438,492,16
Noviembre,Extranjero,10,4,6,16
Noviembre,Ignorado,2,1,1,16
Diciembre,Todos los departamentos,30668,15594,15074,16
Diciembre,Guatemala,5364,2696,2668,16
Diciembre,El Progreso,321,168,153,16
Diciembre,Sacatepéquez,496,256,240,16
Diciembre,Chimaltenango,1341,714,627,16
Diciembre,Escuintla,1248,645,603,16
Diciembre,Santa Rosa,677,339,338,16
Diciembre,Sololá,826,429,397,16
Diciembre,Totonicapán,1013,538,475,16
Diciembre,Quetzaltenango,1590,847,743,16
Diciembre,Suchitepéquez,1046,535,511,16
Diciembre,Retalhuleu,662,345,317,16
Diciembre,San Marcos,2391,1234,1157,16
Diciembre,Huehuetenango,3110,1582,1528,16
Diciembre,Quiché,2268,1147,1121,16
Diciembre,Baja Verapaz,666,344,322,16
Diciembre,Alta Verapaz,2799,1396,1403,16
Diciembre,Petén,1193,590,603,16
Diciembre,Izabal,725,342,383,16
Diciembre,Zacapa,418,193,225,16
Diciembre,Chiquimula,850,443,407,16
Diciembre,Jalapa,739,360,379,16
Diciembre,Jutiapa,911,447,464,16
Diciembre,Extranjero,12,3,9,16
Diciembre,Ignorado,2,1,1,16
Todos los meses,Todos los departamentos,381664,194506,187158,17
Todos los meses,Guatemala,66407,33931,32476,17
Todos los meses,El Progreso,3990,2012,1978,17
Todos los meses,Sacatepéquez,6631,3382,3249,17
Todos los meses,Chimaltenango,15824,8058,7766,17
Todos los meses,Escuintla,16249,8292,7957,17
Todos los meses,Santa Rosa,8464,4335,4129,17
Todos los meses,Sololá,10209,5135,5074,17
Todos los meses,Totonicapán,12744,6589,6155,17
Todos los meses,Quetzaltenango,20248,10297,9951,17
Todos los meses,Suchitepéquez,13549,6878,6671,17
Todos los meses,Retalhuleu,8115,4104,4011,17
Todos los meses,San Marcos,30133,15337,14796,17
Todos los meses,Huehuetenango,37607,19064,18543,17
Todos los meses,Quiché,28651,14610,14041,17
Todos los meses,Baja Verapaz,7912,3980,3932,17
Todos los meses,Alta Verapaz,33966,17447,16519,17
Todos los meses,Petén,14808,7536,7272,17
Todos los meses,Izabal,9789,4934,4855,17
Todos los meses,Zacapa,5885,3027,2858,17
Todos los meses,Chiquimula,10495,5321,5174,17
Todos los meses,Jalapa,8972,4602,4370,17
Todos los meses,Jutiapa,10748,5505,5243,17
Todos los meses,Extranjero,194,97,97,17
Todos los meses,Ignorado,74,33,41,17
Enero,Todos los departamentos,30943,15636,15307,17
Enero,Guatemala,5432,2732,2700,17
Enero,El Progreso,292,153,139,17
Enero,Sacatepéquez,548,277,271,17
Enero,Chimaltenango,1313,695,618,17
Enero,Escuintla,1212,622,590,17
Enero,Santa Rosa,662,319,343,17
Enero,Sololá,896,431,465,17
Enero,Totonicapán,1022,518,504,17
Enero,Quetzaltenango,1677,849,828,17
Enero,Suchitepéquez,1070,530,540,17
Enero,Retalhuleu,638,316,322,17
Enero,San Marcos,2457,1224,1233,17
Enero,Huehuetenango,3149,1553,1596,17
Enero,Quiché,2360,1186,1174,17
Enero,Baja Verapaz,630,317,313,17
Enero,Alta Verapaz,2693,1402,1291,17
Enero,Petén,1129,563,566,17
Enero,Izabal,735,384,351,17
Enero,Zacapa,470,226,244,17
Enero,Chiquimula,890,467,423,17
Enero,Jalapa,764,395,369,17
Enero,Jutiapa,884,468,416,17
Enero,Extranjero,15,7,8,17
Enero,Ignorado,5,2,3,17
Febrero,Todos los departamentos,27610,14133,13477,17
Febrero,Guatemala,4798,2467,2331,17
Febrero,El Progreso,300,158,142,17
Febrero,Sacatepéquez,515,271,244,17
Febrero,Chimaltenango,1257,651,606,17
Febrero,Escuintla,1116,547,569,17
Febrero,Santa Rosa,524,286,238,17
Febrero,Sololá,764,391,373,17
Febrero,Totonicapán,1017,511,506,17
Febrero,Quetzaltenango,1421,710,711,17
Febrero,Suchitepéquez,1002,508,494,17
Febrero,Retalhuleu,619,316,303,17
Febrero,San Marcos,2255,1130,1125,17
Febrero,Huehuetenango,2722,1334,1388,17
Febrero,Quiché,2190,1131,1059,17
Febrero,Baja Verapaz,599,312,287,17
Febrero,Alta Verapaz,2337,1241,1096,17
Febrero,Petén,935,495,440,17
Febrero,Izabal,603,291,312,17
Febrero,Zacapa,382,212,170,17
Febrero,Chiquimula,828,412,416,17
Febrero,Jalapa,648,340,308,17
Febrero,Jutiapa,764,414,350,17
Febrero,Extranjero,10,5,5,17
Febrero,Ignorado,4,0,4,17
Marzo,Todos los departamentos,31876,16153,15723,17
Marzo,Guatemala,5714,2901,2813,17
Marzo,El Progreso,340,175,165,17
Marzo,Sacatepéquez,561,299,262,17
Marzo,Chimaltenango,1418,719,699,17
Marzo,Escuintla,1385,693,692,17
Marzo,Santa Rosa,674,323,351,17
Marzo,Sololá,907,471,436,17
Marzo,Totonicapán,1115,574,541,17
Marzo,Quetzaltenango,1770,880,890,17
Marzo,Suchitepéquez,1129,563,566,17
Marzo,Retalhuleu,645,351,294,17
Marzo,San Marcos,2504,1298,1206,17
Marzo,Huehuetenango,3085,1541,1544,17
Marzo,Quiché,2462,1235,1227,17
Marzo,Baja Verapaz,675,338,337,17
Marzo,Alta Verapaz,2646,1315,1331,17
Marzo,Petén,1094,573,521,17
Marzo,Izabal,747,375,372,17
Marzo,Zacapa,483,237,246,17
Marzo,Chiquimula,902,460,442,17
Marzo,Jalapa,706,340,366,17
Marzo,Jutiapa,894,481,413,17
Marzo,Extranjero,9,6,3,17
Marzo,Ignorado,11,5,6,17
Abril,Todos los departamentos,30987,15865,15122,17
Abril,Guatemala,5278,2757,2521,17
Abril,El Progreso,331,167,164,17
Abril,Sacatepéquez,543,292,251,17
Abril,Chimaltenango,1207,581,626,17
Abril,Escuintla,1301,663,638,17
Abril,Santa Rosa,677,362,315,17
Abril,Sololá,861,427,434,17
Abril,Totonicapán,1040,528,512,17
Abril,Quetzaltenango,1664,832,832,17
Abril,Suchitepéquez,1083,559,524,17
Abril,Retalhuleu,647,320,327,17
Abril,San Marcos,2482,1222,1260,17
Abril,Huehuetenango,3096,1600,1496,17
Abril,Quiché,2423,1267,1156,17
Abril,Baja Verapaz,691,351,340,17
Abril,Alta Verapaz,2740,1407,1333,17
Abril,Petén,1221,632,589,17
Abril,Izabal,808,414,394,17
Abril,Zacapa,487,245,242,17
Abril,Chiquimula,834,425,409,17
Abril,Jalapa,691,380,311,17
Abril,Jutiapa,864,423,441,17
Abril,Extranjero,11,6,5,17
Abril,Ignorado,7,5,2,17
Mayo,Todos los departamentos,32381,16656,15725,17
Mayo,Guatemala,5570,2887,2683,17
Mayo,El Progreso,325,158,167,17
Mayo,Sacatepéquez,594,318,276,17
Mayo,Chimaltenango,1269,636,633,17
Mayo,Escuintla,1387,706,681,17
Mayo,Santa Rosa,758,389,369,17
Mayo,Sololá,847,456,391,17
Mayo,Totonicapán,1113,605,508,17
Mayo,Quetzaltenango,1664,849,815,17
Mayo,Suchitepéquez,1184,590,594,17
Mayo,Retalhuleu,707,374,333,17
Mayo,San Marcos,2665,1353,1312,17
Mayo,Huehuetenango,3089,1587,1502,17
Mayo,Quiché,2463,1277,1186,17
Mayo,Baja Verapaz,675,342,333,17
Mayo,Alta Verapaz,2933,1482,1451,17
Mayo,Petén,1299,661,638,17
Mayo,Izabal,764,385,379,17
Mayo,Zacapa,492,251,241,17
Mayo,Chiquimula,962,509,453,17
Mayo,Jalapa,696,365,331,17
Mayo,Jutiapa,900,463,437,17
Mayo,Extranjero,15,9,6,17
Mayo,Ignorado,10,4,6,17
Junio,Todos los departamentos,31607,16233,15374,17
Junio,Guatemala,5637,2875,2762,17
Junio,El Progreso,321,144,177,17
Junio,Sacatepéquez,545,273,272,17
Junio,Chimaltenango,1309,672,637,17
Junio,Escuintla,1344,698,646,17
Junio,Santa Rosa,713,384,329,17
Junio,Sololá,831,419,412,17
Junio,Totonicapán,1052,562,490,17
Junio,Quetzaltenango,1693,888,805,17
Junio,Suchitepéquez,1153,585,568,17
Junio,Retalhuleu,645,328,317,17
Junio,San Marcos,2465,1281,1184,17
Junio,Huehuetenango,3085,1570,1515,17
Junio,Quiché,2380,1188,1192,17
Junio,Baja Verapaz,683,348,335,17
Junio,Alta Verapaz,2769,1469,1300,17
Junio,Petén,1179,581,598,17
Junio,Izabal,760,403,357,17
Junio,Zacapa,485,278,207,17
Junio,Chiquimula,926,464,462,17
Junio,Jalapa,724,367,357,17
Junio,Jutiapa,888,448,440,17
Junio,Extranjero,16,7,9,17
Junio,Ignorado,4,1,3,17
Julio,Todos los departamentos,32644,16445,16199,17
Julio,Guatemala,5857,2949,2908,17
Julio,El Progreso,352,171,181,17
Julio,Sacatepéquez,533,247,286,17
Julio,Chimaltenango,1342,674,668,17
Julio,Escuintla,1395,717,678,17
Julio,Santa Rosa,754,361,393,17
Julio,Sololá,839,411,428,17
Julio,Totonicapán,1038,529,509,17
Julio,Quetzaltenango,1737,890,847,17
Julio,Suchitepéquez,1154,586,568,17
Julio,Retalhuleu,686,350,336,17
Julio,San Marcos,2551,1281,1270,17
Julio,Huehuetenango,3220,1627,1593,17
Julio,Quiché,2465,1241,1224,17
Julio,Baja Verapaz,681,338,343,17
Julio,Alta Verapaz,2884,1510,1374,17
Julio,Petén,1248,627,621,17
Julio,Izabal,849,432,417,17
Julio,Zacapa,489,242,247,17
Julio,Chiquimula,894,434,460,17
Julio,Jalapa,742,357,385,17
Julio,Jutiapa,901,457,444,17
Julio,Extranjero,26,11,15,17
Julio,Ignorado,7,3,4,17
Agosto,Todos los departamentos,32887,16670,16217,17
Agosto,Guatemala,5797,2890,2907,17
Agosto,El Progreso,350,170,180,17
Agosto,Sacatepéquez,587,300,287,17
Agosto,Chimaltenango,1387,711,676,17
Agosto,Escuintla,1394,732,662,17
Agosto,Santa Rosa,708,372,336,17
Agosto,Sololá,846,437,409,17
Agosto,Totonicapán,1021,536,485,17
Agosto,Quetzaltenango,1762,923,839,17
Agosto,Suchitepéquez,1124,560,564,17
Agosto,Retalhuleu,694,354,340,17
Agosto,San Marcos,2581,1313,1268,17
Agosto,Huehuetenango,3190,1569,1621,17
Agosto,Quiché,2401,1240,1161,17
Agosto,Baja Verapaz,661,311,350,17
Agosto,Alta Verapaz,2926,1472,1454,17
Agosto,Petén,1368,705,663,17
Agosto,Izabal,930,472,458,17
Agosto,Zacapa,542,265,277,17
Agosto,Chiquimula,860,423,437,17
Agosto,Jalapa,766,413,353,17
Agosto,Jutiapa,971,493,478,17
Agosto,Extranjero,15,7,8,17
Agosto,Ignorado,6,2,4,17
Septiembre,Todos los departamentos,33514,17027,16487,17
Septiembre,Guatemala,5785,2960,2825,17
Septiembre,El Progreso,371,206,165,17
Septiembre,Sacatepéquez,598,297,301,17
Septiembre,Chimaltenango,1378,703,675,17
Septiembre,Escuintla,1407,694,713,17
Septiembre,Santa Rosa,814,395,419,17
Septiembre,Sololá,846,436,410,17
Septiembre,Totonicapán,1086,536,550,17
Septiembre,Quetzaltenango,1774,898,876,17
Septiembre,Suchitepéquez,1209,616,593,17
Septiembre,Retalhuleu,681,342,339,17
Septiembre,San Marcos,2608,1314,1294,17
Septiembre,Huehuetenango,3369,1769,1600,17
Septiembre,Quiché,2398,1199,1199,17
Septiembre,Baja Verapaz,623,306,317,17
Septiembre,Alta Verapaz,3123,1597,1526,17
Septiembre,Petén,1364,684,680,17
Septiembre,Izabal,942,470,472,17
Septiembre,Zacapa,523,276,247,17
Septiembre,Chiquimula,860,432,428,17
Septiembre,Jalapa,765,398,367,17
Septiembre,Jutiapa,964,487,477,17
Septiembre,Extranjero,18,8,10,17
Septiembre,Ignorado,8,4,4,17
Octubre,Todos los departamentos,33822,17340,16482,17
Octubre,Guatemala,5846,3029,2817,17
Octubre,El Progreso,377,190,187,17
Octubre,Sacatepéquez,572,292,280,17
Octubre,Chimaltenango,1356,686,670,17
Octubre,Escuintla,1539,763,776,17
Octubre,Santa Rosa,742,386,356,17
Octubre,Sololá,885,446,439,17
Octubre,Totonicapán,1170,596,574,17
Octubre,Quetzaltenango,1769,923,846,17
Octubre,Suchitepéquez,1205,624,581,17
Octubre,Retalhuleu,784,393,391,17
Octubre,San Marcos,2610,1365,1245,17
Octubre,Huehuetenango,3337,1695,1642,17
Octubre,Quiché,2441,1266,1175,17
Octubre,Baja Verapaz,652,347,305,17
Octubre,Alta Verapaz,3023,1520,1503,17
Octubre,Petén,1420,745,675,17
Octubre,Izabal,922,452,470,17
Octubre,Zacapa,536,292,244,17
Octubre,Chiquimula,857,445,412,17
Octubre,Jalapa,815,395,420,17
Octubre,Jutiapa,943,476,467,17
Octubre,Extranjero,16,9,7,17
Octubre,Ignorado,5,5,0,17
Noviembre,Todos los departamentos,31469,16116,15353,17
Noviembre,Guatemala,5404,2815,2589,17
Noviembre,El Progreso,332,166,166,17
Noviembre,Sacatepéquez,499,233,266,17
Noviembre,Chimaltenango,1246,632,614,17
Noviembre,Escuintla,1428,741,687,17
Noviembre,Santa Rosa,730,400,330,17
Noviembre,Sololá,826,395,431,17
Noviembre,Totonicapán,1025,533,492,17
Noviembre,Quetzaltenango,1672,836,836,17
Noviembre,Suchitepéquez,1109,566,543,17
Noviembre,Retalhuleu,698,337,361,17
Noviembre,San Marcos,2485,1256,1229,17
Noviembre,Huehuetenango,3108,1561,1547,17
Noviembre,Quiché,2253,1164,1089,17
Noviembre,Baja Verapaz,673,354,319,17
Noviembre,Alta Verapaz,2858,1503,1355,17
Noviembre,Petén,1223,616,607,17
Noviembre,Izabal,906,465,441,17
Noviembre,Zacapa,492,238,254,17
Noviembre,Chiquimula,822,440,382,17
Noviembre,Jalapa,826,431,395,17
Noviembre,Jutiapa,825,420,405,17
Noviembre,Extranjero,24,13,11,17
Noviembre,Ignorado,5,1,4,17
Diciembre,Todos los departamentos,31924,16232,15692,17
Diciembre,Guatemala,5289,2669,2620,17
Diciembre,El Progreso,299,154,145,17
Diciembre,Sacatepéquez,536,283,253,17
Diciembre,Chimaltenango,1342,698,644,17
Diciembre,Escuintla,1341,716,625,17
Diciembre,Santa Rosa,708,358,350,17
Diciembre,Sololá,861,415,446,17
Diciembre,Totonicapán,1045,561,484,17
Diciembre,Quetzaltenango,1645,819,826,17
Diciembre,Suchitepéquez,1127,591,536,17
Diciembre,Retalhuleu,671,323,348,17
Diciembre,San Marcos,2470,1300,1170,17
Diciembre,Huehuetenango,3157,1658,1499,17
Diciembre,Quiché,2415,1216,1199,17
Diciembre,Baja Verapaz,669,316,353,17
Diciembre,Alta Verapaz,3034,1529,1505,17
Diciembre,Petén,1328,654,674,17
Diciembre,Izabal,823,391,432,17
Diciembre,Zacapa,504,265,239,17
Diciembre,Chiquimula,860,410,450,17
Diciembre,Jalapa,829,421,408,17
Diciembre,Jutiapa,950,475,475,17
Diciembre,Extranjero,19,9,10,17
Diciembre,Ignorado,2,1,1,17
Todos los meses,Todos los departamentos,383263,194923,188340,18
Todos los meses,Guatemala,64735,32690,32045,18
Todos los meses,El Progreso,3920,2067,1853,18
Todos los meses,Sacatepéquez,6545,3345,3200,18
Todos los meses,Chimaltenango,15540,7892,7648,18
Todos los meses,Escuintla,16321,8417,7904,18
Todos los meses,Santa Rosa,8228,4211,4017,18
Todos los meses,Sololá,10168,5183,4985,18
Todos los meses,Totonicapán,12945,6610,6335,18
Todos los meses,Quetzaltenango,20050,10191,9859,18
Todos los meses,Suchitepéquez,13623,6999,6624,18
Todos los meses,Retalhuleu,8236,4209,4027,18
Todos los meses,San Marcos,29426,14958,14468,18
Todos los meses,Huehuetenango,38156,19379,18777,18
Todos los meses,Quiché,30168,15360,14808,18
Todos los meses,Baja Verapaz,8030,4085,3945,18
Todos los meses,Alta Verapaz,34819,17657,17162,18
Todos los meses,Petén,15427,7830,7597,18
Todos los meses,Izabal,10130,5101,5029,18
Todos los meses,Zacapa,5835,2917,2918,18
Todos los meses,Chiquimula,10698,5464,5234,18
Todos los meses,Jalapa,9305,4763,4542,18
Todos los meses,Jutiapa,10536,5373,5163,18
Todos los meses,Extranjero,339,180,159,18
Todos los meses,Ignorado,83,42,41,18
Enero,Todos los departamentos,32679,16651,16028,18
Enero,Guatemala,5610,2861,2749,18
Enero,El Progreso,310,167,143,18
Enero,Sacatepéquez,563,298,265,18
Enero,Chimaltenango,1369,701,668,18
Enero,Escuintla,1380,691,689,18
Enero,Santa Rosa,732,349,383,18
Enero,Sololá,859,441,418,18
Enero,Totonicapán,1118,554,564,18
Enero,Quetzaltenango,1633,830,803,18
Enero,Suchitepéquez,1151,603,548,18
Enero,Retalhuleu,732,376,356,18
Enero,San Marcos,2527,1300,1227,18
Enero,Huehuetenango,3220,1668,1552,18
Enero,Quiché,2625,1325,1300,18
Enero,Baja Verapaz,706,359,347,18
Enero,Alta Verapaz,2945,1502,1443,18
Enero,Petén,1183,593,590,18
Enero,Izabal,858,451,407,18
Enero,Zacapa,477,239,238,18
Enero,Chiquimula,940,465,475,18
Enero,Jalapa,829,418,411,18
Enero,Jutiapa,890,449,441,18
Enero,Extranjero,14,6,8,18
Enero,Ignorado,8,5,3,18
Febrero,Todos los departamentos,28397,14424,13973,18
Febrero,Guatemala,4987,2493,2494,18
Febrero,El Progreso,279,121,158,18
Febrero,Sacatepéquez,446,202,244,18
Febrero,Chimaltenango,1220,614,606,18
Febrero,Escuintla,1146,573,573,18
Febrero,Santa Rosa,654,346,308,18
Febrero,Sololá,755,368,387,18
Febrero,Totonicapán,1012,544,468,18
Febrero,Quetzaltenango,1490,790,700,18
Febrero,Suchitepéquez,975,484,491,18
Febrero,Retalhuleu,618,319,299,18
Febrero,San Marcos,2174,1092,1082,18
Febrero,Huehuetenango,2793,1417,1376,18
Febrero,Quiché,2351,1197,1154,18
Febrero,Baja Verapaz,607,312,295,18
Febrero,Alta Verapaz,2463,1268,1195,18
Febrero,Petén,948,482,466,18
Febrero,Izabal,693,377,316,18
Febrero,Zacapa,441,208,233,18
Febrero,Chiquimula,826,421,405,18
Febrero,Jalapa,693,365,328,18
Febrero,Jutiapa,788,407,381,18
Febrero,Extranjero,30,20,10,18
Febrero,Ignorado,8,4,4,18
Marzo,Todos los departamentos,31924,16209,15715,18
Marzo,Guatemala,5526,2786,2740,18
Marzo,El Progreso,313,178,135,18
Marzo,Sacatepéquez,568,286,282,18
Marzo,Chimaltenango,1307,642,665,18
Marzo,Escuintla,1382,716,666,18
Marzo,Santa Rosa,680,363,317,18
Marzo,Sololá,838,417,421,18
Marzo,Totonicapán,1131,578,553,18
Marzo,Quetzaltenango,1716,829,887,18
Marzo,Suchitepéquez,1143,597,546,18
Marzo,Retalhuleu,699,372,327,18
Marzo,San Marcos,2452,1248,1204,18
Marzo,Huehuetenango,3121,1531,1590,18
Marzo,Quiché,2628,1383,1245,18
Marzo,Baja Verapaz,672,335,337,18
Marzo,Alta Verapaz,2780,1432,1348,18
Marzo,Petén,1180,593,587,18
Marzo,Izabal,755,379,376,18
Marzo,Zacapa,479,214,265,18
Marzo,Chiquimula,897,469,428,18
Marzo,Jalapa,742,386,356,18
Marzo,Jutiapa,879,448,431,18
Marzo,Extranjero,32,24,8,18
Marzo,Ignorado,4,3,1,18
Abril,Todos los departamentos,31104,15894,15210,18
Abril,Guatemala,5431,2772,2659,18
Abril,El Progreso,273,146,127,18
Abril,Sacatepéquez,511,266,245,18
Abril,Chimaltenango,1199,586,613,18
Abril,Escuintla,1219,639,580,18
Abril,Santa Rosa,683,361,322,18
Abril,Sololá,783,399,384,18
Abril,Totonicapán,1052,527,525,18
Abril,Quetzaltenango,1682,846,836,18
Abril,Suchitepéquez,1044,533,511,18
Abril,Retalhuleu,659,331,328,18
Abril,San Marcos,2413,1243,1170,18
Abril,Huehuetenango,3109,1583,1526,18
Abril,Quiché,2552,1289,1263,18
Abril,Baja Verapaz,668,361,307,18
Abril,Alta Verapaz,2863,1485,1378,18
Abril,Petén,1247,636,611,18
Abril,Izabal,771,390,381,18
Abril,Zacapa,479,251,228,18
Abril,Chiquimula,873,440,433,18
Abril,Jalapa,764,384,380,18
Abril,Jutiapa,795,405,390,18
Abril,Extranjero,26,15,11,18
Abril,Ignorado,8,6,2,18
Mayo,Todos los departamentos,31907,16235,15672,18
Mayo,Guatemala,5528,2743,2785,18
Mayo,El Progreso,330,182,148,18
Mayo,Sacatepéquez,547,265,282,18
Mayo,Chimaltenango,1264,650,614,18
Mayo,Escuintla,1273,659,614,18
Mayo,Santa Rosa,676,340,336,18
Mayo,Sololá,825,434,391,18
Mayo,Totonicapán,1078,574,504,18
Mayo,Quetzaltenango,1726,868,858,18
Mayo,Suchitepéquez,1120,584,536,18
Mayo,Retalhuleu,708,375,333,18
Mayo,San Marcos,2402,1240,1162,18
Mayo,Huehuetenango,3202,1613,1589,18
Mayo,Quiché,2557,1329,1228,18
Mayo,Baja Verapaz,676,350,326,18
Mayo,Alta Verapaz,2830,1430,1400,18
Mayo,Petén,1282,646,636,18
Mayo,Izabal,827,394,433,18
Mayo,Zacapa,462,233,229,18
Mayo,Chiquimula,914,440,474,18
Mayo,Jalapa,741,376,365,18
Mayo,Jutiapa,903,491,412,18
Mayo,Extranjero,30,18,12,18
Mayo,Ignorado,6,1,5,18
Junio,Todos los departamentos,30153,15346,14807,18
Junio,Guatemala,5221,2599,2622,18
Junio,El Progreso,327,180,147,18
Junio,Sacatepéquez,507,270,237,18
Junio,Chimaltenango,1252,667,585,18
Junio,Escuintla,1311,648,663,18
Junio,Santa Rosa,611,331,280,18
Junio,Sololá,820,415,405,18
Junio,Totonicapán,1039,524,515,18
Junio,Quetzaltenango,1586,824,762,18
Junio,Suchitepéquez,1082,572,510,18
Junio,Retalhuleu,630,305,325,18
Junio,San Marcos,2362,1178,1184,18
Junio,Huehuetenango,3036,1540,1496,18
Junio,Quiché,2371,1237,1134,18
Junio,Baja Verapaz,607,326,281,18
Junio,Alta Verapaz,2688,1328,1360,18
Junio,Petén,1140,577,563,18
Junio,Izabal,717,343,374,18
Junio,Zacapa,433,233,200,18
Junio,Chiquimula,855,460,395,18
Junio,Jalapa,725,368,357,18
Junio,Jutiapa,798,403,395,18
Junio,Extranjero,25,12,13,18
Junio,Ignorado,10,6,4,18
Julio,Todos los departamentos,31871,16283,15588,18
Julio,Guatemala,5523,2802,2721,18
Julio,El Progreso,315,162,153,18
Julio,Sacatepéquez,562,293,269,18
Julio,Chimaltenango,1310,681,629,18
Julio,Escuintla,1373,728,645,18
Julio,Santa Rosa,633,319,314,18
Julio,Sololá,910,468,442,18
Julio,Totonicapán,1099,558,541,18
Julio,Quetzaltenango,1653,824,829,18
Julio,Suchitepéquez,1148,588,560,18
Julio,Retalhuleu,673,349,324,18
Julio,San Marcos,2451,1278,1173,18
Julio,Huehuetenango,3126,1614,1512,18
Julio,Quiché,2548,1281,1267,18
Julio,Baja Verapaz,679,339,340,18
Julio,Alta Verapaz,2818,1390,1428,18
Julio,Petén,1321,686,635,18
Julio,Izabal,837,425,412,18
Julio,Zacapa,464,246,218,18
Julio,Chiquimula,835,426,409,18
Julio,Jalapa,742,388,354,18
Julio,Jutiapa,818,419,399,18
Julio,Extranjero,27,16,11,18
Julio,Ignorado,6,3,3,18
Agosto,Todos los departamentos,32820,16714,16106,18
Agosto,Guatemala,5419,2712,2707,18
Agosto,El Progreso,335,168,167,18
Agosto,Sacatepéquez,547,283,264,18
Agosto,Chimaltenango,1257,651,606,18
Agosto,Escuintla,1424,783,641,18
Agosto,Santa Rosa,690,344,346,18
Agosto,Sololá,890,452,438,18
Agosto,Totonicapán,1073,537,536,18
Agosto,Quetzaltenango,1672,858,814,18
Agosto,Suchitepéquez,1141,603,538,18
Agosto,Retalhuleu,684,358,326,18
Agosto,San Marcos,2481,1255,1226,18
Agosto,Huehuetenango,3252,1656,1596,18
Agosto,Quiché,2517,1288,1229,18
Agosto,Baja Verapaz,662,325,337,18
Agosto,Alta Verapaz,3064,1559,1505,18
Agosto,Petén,1484,770,714,18
Agosto,Izabal,1039,518,521,18
Agosto,Zacapa,517,241,276,18
Agosto,Chiquimula,858,425,433,18
Agosto,Jalapa,777,398,379,18
Agosto,Jutiapa,995,509,486,18
Agosto,Extranjero,34,18,16,18
Agosto,Ignorado,8,3,5,18
Septiembre,Todos los departamentos,34723,17497,17226,18
Septiembre,Guatemala,5706,2876,2830,18
Septiembre,El Progreso,392,211,181,18
Septiembre,Sacatepéquez,584,292,292,18
Septiembre,Chimaltenango,1357,686,671,18
Septiembre,Escuintla,1518,792,726,18
Septiembre,Santa Rosa,764,380,384,18
Septiembre,Sololá,945,502,443,18
Septiembre,Totonicapán,1121,563,558,18
Septiembre,Quetzaltenango,1743,878,865,18
Septiembre,Suchitepéquez,1245,623,622,18
Septiembre,Retalhuleu,724,352,372,18
Septiembre,San Marcos,2677,1337,1340,18
Septiembre,Huehuetenango,3517,1774,1743,18
Septiembre,Quiché,2577,1288,1289,18
Septiembre,Baja Verapaz,672,321,351,18
Septiembre,Alta Verapaz,3342,1656,1686,18
Septiembre,Petén,1547,758,789,18
Septiembre,Izabal,988,516,472,18
Septiembre,Zacapa,582,295,287,18
Septiembre,Chiquimula,962,502,460,18
Septiembre,Jalapa,807,410,397,18
Septiembre,Jutiapa,922,473,449,18
Septiembre,Extranjero,25,9,16,18
Septiembre,Ignorado,6,3,3,18
Octubre,Todos los departamentos,34192,17549,16643,18
Octubre,Guatemala,5564,2869,2695,18
Octubre,El Progreso,360,187,173,18
Octubre,Sacatepéquez,640,331,309,18
Octubre,Chimaltenango,1382,701,681,18
Octubre,Escuintla,1541,773,768,18
Octubre,Santa Rosa,756,385,371,18
Octubre,Sololá,842,441,401,18
Octubre,Totonicapán,1127,616,511,18
Octubre,Quetzaltenango,1807,927,880,18
Octubre,Suchitepéquez,1202,626,576,18
Octubre,Retalhuleu,766,384,382,18
Octubre,San Marcos,2656,1360,1296,18
Octubre,Huehuetenango,3275,1655,1620,18
Octubre,Quiché,2508,1279,1229,18
Octubre,Baja Verapaz,704,374,330,18
Octubre,Alta Verapaz,3128,1596,1532,18
Octubre,Petén,1560,807,753,18
Octubre,Izabal,973,491,482,18
Octubre,Zacapa,547,281,266,18
Octubre,Chiquimula,958,509,449,18
Octubre,Jalapa,853,426,427,18
Octubre,Jutiapa,1001,513,488,18
Octubre,Extranjero,34,16,18,18
Octubre,Ignorado,8,2,6,18
Noviembre,Todos los departamentos,31757,16033,15724,18
Noviembre,Guatemala,5110,2579,2531,18
Noviembre,El Progreso,350,181,169,18
Noviembre,Sacatepéquez,571,299,272,18
Noviembre,Chimaltenango,1282,629,653,18
Noviembre,Escuintla,1386,725,661,18
Noviembre,Santa Rosa,678,346,332,18
Noviembre,Sololá,832,405,427,18
Noviembre,Totonicapán,1035,506,529,18
Noviembre,Quetzaltenango,1688,862,826,18
Noviembre,Suchitepéquez,1224,610,614,18
Noviembre,Retalhuleu,676,347,329,18
Noviembre,San Marcos,2321,1168,1153,18
Noviembre,Huehuetenango,3211,1618,1593,18
Noviembre,Quiché,2454,1227,1227,18
Noviembre,Baja Verapaz,662,336,326,18
Noviembre,Alta Verapaz,2960,1520,1440,18
Noviembre,Petén,1378,696,682,18
Noviembre,Izabal,854,409,445,18
Noviembre,Zacapa,485,246,239,18
Noviembre,Chiquimula,874,434,440,18
Noviembre,Jalapa,813,435,378,18
Noviembre,Jutiapa,870,433,437,18
Noviembre,Extranjero,34,16,18,18
Noviembre,Ignorado,9,6,3,18
Diciembre,Todos los departamentos,31736,16088,15648,18
Diciembre,Guatemala,5110,2598,2512,18
Diciembre,El Progreso,336,184,152,18
Diciembre,Sacatepéquez,499,260,239,18
Diciembre,Chimaltenango,1341,684,657,18
Diciembre,Escuintla,1368,690,678,18
Diciembre,Santa Rosa,671,347,324,18
Diciembre,Sololá,869,441,428,18
Diciembre,Totonicapán,1060,529,531,18
Diciembre,Quetzaltenango,1654,855,799,18
Diciembre,Suchitepéquez,1148,576,572,18
Diciembre,Retalhuleu,667,341,326,18
Diciembre,San Marcos,2510,1259,1251,18
Diciembre,Huehuetenango,3294,1710,1584,18
Diciembre,Quiché,2480,1237,1243,18
Diciembre,Baja Verapaz,715,347,368,18
Diciembre,Alta Verapaz,2938,1491,1447,18
Diciembre,Petén,1157,586,571,18
Diciembre,Izabal,818,408,410,18
Diciembre,Zacapa,469,230,239,18
Diciembre,Chiquimula,906,473,433,18
Diciembre,Jalapa,819,409,410,18
Diciembre,Jutiapa,877,423,454,18
Diciembre,Extranjero,28,10,18,18
Diciembre,Ignorado,2,0,2,18
Todos los meses,Todos los departamentos,366855,186641,180214,19
Todos los meses,Guatemala,59563,30141,29422,19
Todos los meses,El Progreso,3709,1880,1829,19
Todos los meses,Sacatepéquez,6341,3230,3111,19
Todos los meses,Chimaltenango,15192,7807,7385,19
Todos los meses,Escuintla,15437,7944,7493,19
Todos los meses,Santa Rosa,8024,4026,3998,19
Todos los meses,Sololá,10021,5125,4896,19
Todos los meses,Totonicapán,12507,6418,6089,19
Todos los meses,Quetzaltenango,19461,9803,9658,19
Todos los meses,Suchitepéquez,13252,6741,6511,19
Todos los meses,Retalhuleu,7752,3996,3756,19
Todos los meses,San Marcos,27460,13969,13491,19
Todos los meses,Huehuetenango,36881,18750,18131,19
Todos los meses,Quiché,29288,14932,14356,19
Todos los meses,Baja Verapaz,7831,3988,3843,19
Todos los meses,Alta Verapaz,34614,17648,16966,19
Todos los meses,Petén,14851,7566,7285,19
Todos los meses,Izabal,9393,4729,4664,19
Todos los meses,Zacapa,5460,2786,2674,19
Todos los meses,Chiquimula,10123,5115,5008,19
Todos los meses,Jalapa,8931,4564,4367,19
Todos los meses,Jutiapa,10357,5282,5075,19
Todos los meses,Extranjero,339,170,169,19
Todos los meses,Ignorado,68,31,37,19
Enero,Todos los departamentos,32017,16450,15567,19
Enero,Guatemala,5153,2624,2529,19
Enero,El Progreso,308,164,144,19
Enero,Sacatepéquez,546,279,267,19
Enero,Chimaltenango,1298,655,643,19
Enero,Escuintla,1375,702,673,19
Enero,Santa Rosa,723,372,351,19
Enero,Sololá,827,423,404,19
Enero,Totonicapán,1093,566,527,19
Enero,Quetzaltenango,1626,792,834,19
Enero,Suchitepéquez,1105,580,525,19
Enero,Retalhuleu,684,379,305,19
Enero,San Marcos,2470,1237,1233,19
Enero,Huehuetenango,3337,1714,1623,19
Enero,Quiché,2586,1373,1213,19
Enero,Baja Verapaz,703,368,335,19
Enero,Alta Verapaz,2999,1553,1446,19
Enero,Petén,1263,628,635,19
Enero,Izabal,795,435,360,19
Enero,Zacapa,494,241,253,19
Enero,Chiquimula,925,495,430,19
Enero,Jalapa,769,394,375,19
Enero,Jutiapa,889,451,438,19
Enero,Extranjero,44,21,23,19
Enero,Ignorado,5,4,1,19
Febrero,Todos los departamentos,28498,14494,14004,19
Febrero,Guatemala,4677,2344,2333,19
Febrero,El Progreso,301,144,157,19
Febrero,Sacatepéquez,523,259,264,19
Febrero,Chimaltenango,1231,628,603,19
Febrero,Escuintla,1159,622,537,19
Febrero,Santa Rosa,594,308,286,19
Febrero,Sololá,774,404,370,19
Febrero,Totonicapán,1003,523,480,19
Febrero,Quetzaltenango,1536,788,748,19
Febrero,Suchitepéquez,1078,551,527,19
Febrero,Retalhuleu,598,299,299,19
Febrero,San Marcos,2092,1064,1028,19
Febrero,Huehuetenango,2911,1473,1438,19
Febrero,Quiché,2341,1198,1143,19
Febrero,Baja Verapaz,635,326,309,19
Febrero,Alta Verapaz,2599,1333,1266,19
Febrero,Petén,1016,499,517,19
Febrero,Izabal,678,340,338,19
Febrero,Zacapa,420,216,204,19
Febrero,Chiquimula,818,412,406,19
Febrero,Jalapa,675,337,338,19
Febrero,Jutiapa,808,415,393,19
Febrero,Extranjero,28,11,17,19
Febrero,Ignorado,3,0,3,19
Marzo,Todos los departamentos,31342,15760,15582,19
Marzo,Guatemala,4982,2513,2469,19
Marzo,El Progreso,325,165,160,19
Marzo,Sacatepéquez,557,268,289,19
Marzo,Chimaltenango,1315,687,628,19
Marzo,Escuintla,1394,722,672,19
Marzo,Santa Rosa,684,344,340,19
Marzo,Sololá,842,441,401,19
Marzo,Totonicapán,1130,571,559,19
Marzo,Quetzaltenango,1633,788,845,19
Marzo,Suchitepéquez,1136,569,567,19
Marzo,Retalhuleu,639,328,311,19
Marzo,San Marcos,2419,1179,1240,19
Marzo,Huehuetenango,3109,1518,1591,19
Marzo,Quiché,2672,1398,1274,19
Marzo,Baja Verapaz,706,369,337,19
Marzo,Alta Verapaz,2780,1362,1418,19
Marzo,Petén,1284,681,603,19
Marzo,Izabal,736,368,368,19
Marzo,Zacapa,446,234,212,19
Marzo,Chiquimula,916,458,458,19
Marzo,Jalapa,697,331,366,19
Marzo,Jutiapa,905,448,457,19
Marzo,Extranjero,26,16,10,19
Marzo,Ignorado,9,2,7,19
Abril,Todos los departamentos,29729,15208,14521,19
Abril,Guatemala,4931,2495,2436,19
Abril,El Progreso,289,151,138,19
Abril,Sacatepéquez,538,264,274,19
Abril,Chimaltenango,1263,688,575,19
Abril,Escuintla,1220,634,586,19
Abril,Santa Rosa,644,302,342,19
Abril,Sololá,807,386,421,19
Abril,Totonicapán,1016,533,483,19
Abril,Quetzaltenango,1618,813,805,19
Abril,Suchitepéquez,1053,555,498,19
Abril,Retalhuleu,601,322,279,19
Abril,San Marcos,2195,1106,1089,19
Abril,Huehuetenango,2985,1558,1427,19
Abril,Quiché,2383,1212,1171,19
Abril,Baja Verapaz,634,307,327,19
Abril,Alta Verapaz,2834,1462,1372,19
Abril,Petén,1207,634,573,19
Abril,Izabal,742,360,382,19
Abril,Zacapa,426,215,211,19
Abril,Chiquimula,811,426,385,19
Abril,Jalapa,676,347,329,19
Abril,Jutiapa,829,423,406,19
Abril,Extranjero,18,9,9,19
Abril,Ignorado,9,6,3,19
Mayo,Todos los departamentos,31097,15862,15235,19
Mayo,Guatemala,5085,2553,2532,19
Mayo,El Progreso,314,150,164,19
Mayo,Sacatepéquez,557,286,271,19
Mayo,Chimaltenango,1319,696,623,19
Mayo,Escuintla,1297,625,672,19
Mayo,Santa Rosa,666,316,350,19
Mayo,Sololá,838,424,414,19
Mayo,Totonicapán,1042,556,486,19
Mayo,Quetzaltenango,1718,904,814,19
Mayo,Suchitepéquez,1090,545,545,19
Mayo,Retalhuleu,629,320,309,19
Mayo,San Marcos,2284,1167,1117,19
Mayo,Huehuetenango,3019,1575,1444,19
Mayo,Quiché,2637,1323,1314,19
Mayo,Baja Verapaz,610,340,270,19
Mayo,Alta Verapaz,2916,1476,1440,19
Mayo,Petén,1338,674,664,19
Mayo,Izabal,826,427,399,19
Mayo,Zacapa,447,222,225,19
Mayo,Chiquimula,827,455,372,19
Mayo,Jalapa,757,384,373,19
Mayo,Jutiapa,848,429,419,19
Mayo,Extranjero,24,11,13,19
Mayo,Ignorado,9,4,5,19
Junio,Todos los departamentos,29886,15216,14670,19
Junio,Guatemala,4771,2466,2305,19
Junio,El Progreso,262,126,136,19
Junio,Sacatepéquez,496,243,253,19
Junio,Chimaltenango,1221,627,594,19
Junio,Escuintla,1259,680,579,19
Junio,Santa Rosa,642,318,324,19
Junio,Sololá,816,429,387,19
Junio,Totonicapán,1053,558,495,19
Junio,Quetzaltenango,1587,813,774,19
Junio,Suchitepéquez,1122,611,511,19
Junio,Retalhuleu,647,312,335,19
Junio,San Marcos,2299,1176,1123,19
Junio,Huehuetenango,2971,1511,1460,19
Junio,Quiché,2446,1183,1263,19
Junio,Baja Verapaz,619,320,299,19
Junio,Alta Verapaz,2896,1483,1413,19
Junio,Petén,1172,585,587,19
Junio,Izabal,750,370,380,19
Junio,Zacapa,428,217,211,19
Junio,Chiquimula,838,404,434,19
Junio,Jalapa,747,363,384,19
Junio,Jutiapa,822,407,415,19
Junio,Extranjero,17,9,8,19
Junio,Ignorado,5,5,0,19
Julio,Todos los departamentos,30782,15645,15137,19
Julio,Guatemala,4967,2479,2488,19
Julio,El Progreso,315,159,156,19
Julio,Sacatepéquez,546,292,254,19
Julio,Chimaltenango,1256,605,651,19
Julio,Escuintla,1328,660,668,19
Julio,Santa Rosa,696,352,344,19
Julio,Sololá,831,415,416,19
Julio,Totonicapán,990,499,491,19
Julio,Quetzaltenango,1648,809,839,19
Julio,Suchitepéquez,1170,584,586,19
Julio,Retalhuleu,649,331,318,19
Julio,San Marcos,2372,1199,1173,19
Julio,Huehuetenango,3039,1588,1451,19
Julio,Quiché,2459,1234,1225,19
Julio,Baja Verapaz,667,325,342,19
Julio,Alta Verapaz,2920,1565,1355,19
Julio,Petén,1276,666,610,19
Julio,Izabal,808,426,382,19
Julio,Zacapa,458,250,208,19
Julio,Chiquimula,821,386,435,19
Julio,Jalapa,692,346,346,19
Julio,Jutiapa,843,456,387,19
Julio,Extranjero,27,17,10,19
Julio,Ignorado,4,2,2,19
Agosto,Todos los departamentos,31155,15884,15271,19
Agosto,Guatemala,5179,2631,2548,19
Agosto,El Progreso,299,153,146,19
Agosto,Sacatepéquez,556,287,269,19
Agosto,Chimaltenango,1274,658,616,19
Agosto,Escuintla,1343,706,637,19
Agosto,Santa Rosa,661,342,319,19
Agosto,Sololá,902,492,410,19
Agosto,Totonicapán,1057,548,509,19
Agosto,Quetzaltenango,1636,843,793,19
Agosto,Suchitepéquez,1069,522,547,19
Agosto,Retalhuleu,662,339,323,19
Agosto,San Marcos,2279,1179,1100,19
Agosto,Huehuetenango,3094,1567,1527,19
Agosto,Quiché,2493,1303,1190,19
Agosto,Baja Verapaz,665,325,340,19
Agosto,Alta Verapaz,2928,1447,1481,19
Agosto,Petén,1254,621,633,19
Agosto,Izabal,830,424,406,19
Agosto,Zacapa,463,231,232,19
Agosto,Chiquimula,792,381,411,19
Agosto,Jalapa,788,406,382,19
Agosto,Jutiapa,903,469,434,19
Agosto,Extranjero,25,9,16,19
Agosto,Ignorado,3,1,2,19
Septiembre,Todos los departamentos,32973,16837,16136,19
Septiembre,Guatemala,5320,2731,2589,19
Septiembre,El Progreso,333,175,158,19
Septiembre,Sacatepéquez,576,308,268,19
Septiembre,Chimaltenango,1351,693,658,19
Septiembre,Escuintla,1289,679,610,19
Septiembre,Santa Rosa,743,384,359,19
Septiembre,Sololá,864,436,428,19
Septiembre,Totonicapán,1128,556,572,19
Septiembre,Quetzaltenango,1698,909,789,19
Septiembre,Suchitepéquez,1176,571,605,19
Septiembre,Retalhuleu,713,361,352,19
Septiembre,San Marcos,2419,1247,1172,19
Septiembre,Huehuetenango,3421,1769,1652,19
Septiembre,Quiché,2495,1264,1231,19
Septiembre,Baja Verapaz,694,348,346,19
Septiembre,Alta Verapaz,3298,1636,1662,19
Septiembre,Petén,1405,707,698,19
Septiembre,Izabal,917,458,459,19
Septiembre,Zacapa,508,254,254,19
Septiembre,Chiquimula,856,433,423,19
Septiembre,Jalapa,788,432,356,19
Septiembre,Jutiapa,936,464,472,19
Septiembre,Extranjero,42,21,21,19
Septiembre,Ignorado,3,1,2,19
Octubre,Todos los departamentos,32117,16216,15901,19
Octubre,Guatemala,5116,2580,2536,19
Octubre,El Progreso,339,180,159,19
Octubre,Sacatepéquez,528,277,251,19
Octubre,Chimaltenango,1292,659,633,19
Octubre,Escuintla,1378,704,674,19
Octubre,Santa Rosa,678,332,346,19
Octubre,Sololá,852,420,432,19
Octubre,Totonicapán,1118,549,569,19
Octubre,Quetzaltenango,1722,849,873,19
Octubre,Suchitepéquez,1203,621,582,19
Octubre,Retalhuleu,718,389,329,19
Octubre,San Marcos,2354,1206,1148,19
Octubre,Huehuetenango,3232,1619,1613,19
Octubre,Quiché,2486,1191,1295,19
Octubre,Baja Verapaz,702,348,354,19
Octubre,Alta Verapaz,3070,1551,1519,19
Octubre,Petén,1327,702,625,19
Octubre,Izabal,874,424,450,19
Octubre,Zacapa,475,249,226,19
Octubre,Chiquimula,865,455,410,19
Octubre,Jalapa,809,416,393,19
Octubre,Jutiapa,941,478,463,19
Octubre,Extranjero,31,16,15,19
Octubre,Ignorado,7,1,6,19
Noviembre,Todos los departamentos,28958,14766,14192,19
Noviembre,Guatemala,4717,2413,2304,19
Noviembre,El Progreso,311,145,166,19
Noviembre,Sacatepéquez,443,226,217,19
Noviembre,Chimaltenango,1156,588,568,19
Noviembre,Escuintla,1218,642,576,19
Noviembre,Santa Rosa,646,317,329,19
Noviembre,Sololá,821,409,412,19
Noviembre,Totonicapán,932,466,466,19
Noviembre,Quetzaltenango,1539,766,773,19
Noviembre,Suchitepéquez,1050,519,531,19
Noviembre,Retalhuleu,628,332,296,19
Noviembre,San Marcos,2195,1162,1033,19
Noviembre,Huehuetenango,2990,1515,1475,19
Noviembre,Quiché,2171,1131,1040,19
Noviembre,Baja Verapaz,594,300,294,19
Noviembre,Alta Verapaz,2750,1416,1334,19
Noviembre,Petén,1206,597,609,19
Noviembre,Izabal,718,360,358,19
Noviembre,Zacapa,456,237,219,19
Noviembre,Chiquimula,805,389,416,19
Noviembre,Jalapa,779,411,368,19
Noviembre,Jutiapa,794,406,388,19
Noviembre,Extranjero,34,17,17,19
Noviembre,Ignorado,5,2,3,19
Diciembre,Todos los departamentos,28301,14303,13998,19
Diciembre,Guatemala,4665,2312,2353,19
Diciembre,El Progreso,313,168,145,19
Diciembre,Sacatepéquez,475,241,234,19
Diciembre,Chimaltenango,1216,623,593,19
Diciembre,Escuintla,1177,568,609,19
Diciembre,Santa Rosa,647,339,308,19
Diciembre,Sololá,847,446,401,19
Diciembre,Totonicapán,945,493,452,19
Diciembre,Quetzaltenango,1500,729,771,19
Diciembre,Suchitepéquez,1000,513,487,19
Diciembre,Retalhuleu,584,284,300,19
Diciembre,San Marcos,2082,1047,1035,19
Diciembre,Huehuetenango,2773,1343,1430,19
Diciembre,Quiché,2119,1122,997,19
Diciembre,Baja Verapaz,602,312,290,19
Diciembre,Alta Verapaz,2624,1364,1260,19
Diciembre,Petén,1103,572,531,19
Diciembre,Izabal,719,337,382,19
Diciembre,Zacapa,439,220,219,19
Diciembre,Chiquimula,849,421,428,19
Diciembre,Jalapa,754,397,357,19
Diciembre,Jutiapa,839,436,403,19
Diciembre,Extranjero,23,13,10,19
Diciembre,Ignorado,6,3,3,19
Todos los meses,Todos los departamentos,341212,173434,167778,20
Todos los meses,Guatemala,54807,27928,26879,20
Todos los meses,El Progreso,3560,1854,1706,20
Todos los meses,Sacatepéquez,6064,3083,2981,20
Todos los meses,Chimaltenango,14090,7101,6989,20
Todos los meses,Escuintla,14102,7206,6896,20
Todos los meses,Santa Rosa,7696,3947,3749,20
Todos los meses,Sololá,9373,4756,4617,20
Todos los meses,Totonicapán,11838,5988,5850,20
Todos los meses,Quetzaltenango,17911,8935,8976,20
Todos los meses,Suchitepéquez,12066,6092,5974,20
Todos los meses,Retalhuleu,7075,3583,3492,20
Todos los meses,San Marcos,26191,13435,12756,20
Todos los meses,Huehuetenango,33839,17122,16717,20
Todos los meses,Quiché,28045,14129,13916,20
Todos los meses,Baja Verapaz,7274,3684,3590,20
Todos los meses,Alta Verapaz,31582,16021,15561,20
Todos los meses,Petén,13358,6883,6475,20
Todos los meses,Izabal,8919,4478,4441,20
Todos los meses,Zacapa,5000,2548,2452,20
Todos los meses,Chiquimula,9693,5031,4662,20
Todos los meses,Jalapa,8457,4327,4130,20
Todos los meses,Jutiapa,9936,5126,4810,20
Todos los meses,Extranjero,223,113,110,20
Todos los meses,Ignorado,113,64,49,20
Enero,Todos los departamentos,30786,15710,15076,20
Enero,Guatemala,4932,2472,2460,20
Enero,El Progreso,328,170,158,20
Enero,Sacatepéquez,537,256,281,20
Enero,Chimaltenango,1307,661,646,20
Enero,Escuintla,1220,607,613,20
Enero,Santa Rosa,705,343,362,20
Enero,Sololá,850,434,416,20
Enero,Totonicapán,1095,539,556,20
Enero,Quetzaltenango,1635,833,802,20
Enero,Suchitepéquez,1024,529,495,20
Enero,Retalhuleu,634,299,335,20
Enero,San Marcos,2356,1236,1120,20
Enero,Huehuetenango,3105,1600,1505,20
Enero,Quiché,2586,1376,1210,20
Enero,Baja Verapaz,672,343,329,20
Enero,Alta Verapaz,2912,1470,1442,20
Enero,Petén,1145,584,561,20
Enero,Izabal,750,372,378,20
Enero,Zacapa,424,231,193,20
Enero,Chiquimula,893,492,401,20
Enero,Jalapa,816,409,407,20
Enero,Jutiapa,828,440,388,20
Enero,Extranjero,24,10,14,20
Enero,Ignorado,8,4,4,20
Febrero,Todos los departamentos,26889,13646,13243,20
Febrero,Guatemala,4380,2266,2114,20
Febrero,El Progreso,267,131,136,20
Febrero,Sacatepéquez,503,252,251,20
Febrero,Chimaltenango,1223,611,612,20
Febrero,Escuintla,1071,554,517,20
Febrero,Santa Rosa,618,308,310,20
Febrero,Sololá,760,366,394,20
Febrero,Totonicapán,957,482,475,20
Febrero,Quetzaltenango,1496,767,729,20
Febrero,Suchitepéquez,957,467,490,20
Febrero,Retalhuleu,529,268,261,20
Febrero,San Marcos,2143,1051,1092,20
Febrero,Huehuetenango,2750,1366,1384,20
Febrero,Quiché,2223,1161,1062,20
Febrero,Baja Verapaz,567,284,283,20
Febrero,Alta Verapaz,2358,1194,1164,20
Febrero,Petén,872,455,417,20
Febrero,Izabal,593,303,290,20
Febrero,Zacapa,345,172,173,20
Febrero,Chiquimula,803,407,396,20
Febrero,Jalapa,659,360,299,20
Febrero,Jutiapa,789,409,380,20
Febrero,Extranjero,18,7,11,20
Febrero,Ignorado,8,5,3,20
Marzo,Todos los departamentos,27925,14165,13760,20
Marzo,Guatemala,4571,2304,2267,20
Marzo,El Progreso,267,133,134,20
Marzo,Sacatepéquez,508,254,254,20
Marzo,Chimaltenango,1157,570,587,20
Marzo,Escuintla,1089,590,499,20
Marzo,Santa Rosa,610,333,277,20
Marzo,Sololá,785,398,387,20
Marzo,Totonicapán,1053,547,506,20
Marzo,Quetzaltenango,1427,704,723,20
Marzo,Suchitepéquez,1016,523,493,20
Marzo,Retalhuleu,607,302,305,20
Marzo,San Marcos,2277,1157,1120,20
Marzo,Huehuetenango,2825,1441,1384,20
Marzo,Quiché,2409,1176,1233,20
Marzo,Baja Verapaz,629,338,291,20
Marzo,Alta Verapaz,2425,1233,1192,20
Marzo,Petén,929,453,476,20
Marzo,Izabal,667,325,342,20
Marzo,Zacapa,396,187,209,20
Marzo,Chiquimula,744,412,332,20
Marzo,Jalapa,715,370,345,20
Marzo,Jutiapa,800,405,395,20
Marzo,Extranjero,7,1,6,20
Marzo,Ignorado,12,9,3,20
Abril,Todos los departamentos,26984,13870,13114,20
Abril,Guatemala,4299,2245,2054,20
Abril,El Progreso,284,151,133,20
Abril,Sacatepéquez,494,263,231,20
Abril,Chimaltenango,1052,510,542,20
Abril,Escuintla,1134,579,555,20
Abril,Santa Rosa,623,344,279,20
Abril,Sololá,768,395,373,20
Abril,Totonicapán,969,515,454,20
Abril,Quetzaltenango,1451,710,741,20
Abril,Suchitepéquez,978,496,482,20
Abril,Retalhuleu,546,273,273,20
Abril,San Marcos,2103,1109,994,20
Abril,Huehuetenango,2627,1310,1317,20
Abril,Quiché,2318,1172,1146,20
Abril,Baja Verapaz,559,289,270,20
Abril,Alta Verapaz,2407,1240,1167,20
Abril,Petén,1040,549,491,20
Abril,Izabal,703,354,349,20
Abril,Zacapa,376,198,178,20
Abril,Chiquimula,793,411,382,20
Abril,Jalapa,676,338,338,20
Abril,Jutiapa,764,406,358,20
Abril,Extranjero,11,5,6,20
Abril,Ignorado,9,8,1,20
Mayo,Todos los departamentos,28069,14241,13828,20
Mayo,Guatemala,4564,2353,2211,20
Mayo,El Progreso,268,132,136,20
Mayo,Sacatepéquez,498,246,252,20
Mayo,Chimaltenango,1113,578,535,20
Mayo,Escuintla,1195,561,634,20
Mayo,Santa Rosa,610,314,296,20
Mayo,Sololá,821,435,386,20
Mayo,Totonicapán,1016,510,506,20
Mayo,Quetzaltenango,1435,746,689,20
Mayo,Suchitepéquez,967,476,491,20
Mayo,Retalhuleu,576,271,305,20
Mayo,San Marcos,2138,1091,1047,20
Mayo,Huehuetenango,2874,1448,1426,20
Mayo,Quiché,2294,1184,1110,20
Mayo,Baja Verapaz,609,290,319,20
Mayo,Alta Verapaz,2577,1272,1305,20
Mayo,Petén,1059,544,515,20
Mayo,Izabal,678,339,339,20
Mayo,Zacapa,442,222,220,20
Mayo,Chiquimula,808,434,374,20
Mayo,Jalapa,688,373,315,20
Mayo,Jutiapa,808,409,399,20
Mayo,Extranjero,21,7,14,20
Mayo,Ignorado,10,6,4,20
Junio,Todos los departamentos,27992,14276,13716,20
Junio,Guatemala,4592,2330,2262,20
Junio,El Progreso,279,139,140,20
Junio,Sacatepéquez,458,249,209,20
Junio,Chimaltenango,1115,520,595,20
Junio,Escuintla,1224,621,603,20
Junio,Santa Rosa,653,319,334,20
Junio,Sololá,750,361,389,20
Junio,Totonicapán,988,520,468,20
Junio,Quetzaltenango,1452,732,720,20
Junio,Suchitepéquez,981,494,487,20
Junio,Retalhuleu,612,321,291,20
Junio,San Marcos,2279,1172,1107,20
Junio,Huehuetenango,2759,1402,1357,20
Junio,Quiché,2280,1138,1142,20
Junio,Baja Verapaz,617,329,288,20
Junio,Alta Verapaz,2504,1296,1208,20
Junio,Petén,1062,561,501,20
Junio,Izabal,699,352,347,20
Junio,Zacapa,356,191,165,20
Junio,Chiquimula,823,427,396,20
Junio,Jalapa,694,355,339,20
Junio,Jutiapa,791,431,360,20
Junio,Extranjero,16,12,4,20
Junio,Ignorado,8,4,4,20
Julio,Todos los departamentos,28855,14724,14131,20
Julio,Guatemala,4749,2425,2324,20
Julio,El Progreso,317,177,140,20
Julio,Sacatepéquez,547,282,265,20
Julio,Chimaltenango,1282,646,636,20
Julio,Escuintla,1264,670,594,20
Julio,Santa Rosa,670,356,314,20
Julio,Sololá,780,415,365,20
Julio,Totonicapán,973,480,493,20
Julio,Quetzaltenango,1519,727,792,20
Julio,Suchitepéquez,1052,546,506,20
Julio,Retalhuleu,629,338,291,20
Julio,San Marcos,2140,1097,1043,20
Julio,Huehuetenango,2873,1446,1427,20
Julio,Quiché,2322,1190,1132,20
Julio,Baja Verapaz,580,282,298,20
Julio,Alta Verapaz,2540,1278,1262,20
Julio,Petén,1132,597,535,20
Julio,Izabal,728,385,343,20
Julio,Zacapa,404,214,190,20
Julio,Chiquimula,797,395,402,20
Julio,Jalapa,662,313,349,20
Julio,Jutiapa,872,450,422,20
Julio,Extranjero,13,10,3,20
Julio,Ignorado,10,5,5,20
Agosto,Todos los departamentos,29159,14779,14380,20
Agosto,Guatemala,4799,2445,2354,20
Agosto,El Progreso,326,182,144,20
Agosto,Sacatepéquez,501,240,261,20
Agosto,Chimaltenango,1234,625,609,20
Agosto,Escuintla,1207,618,589,20
Agosto,Santa Rosa,662,346,316,20
Agosto,Sololá,759,391,368,20
Agosto,Totonicapán,931,469,462,20
Agosto,Quetzaltenango,1551,782,769,20
Agosto,Suchitepéquez,1085,521,564,20
Agosto,Retalhuleu,561,273,288,20
Agosto,San Marcos,2185,1118,1067,20
Agosto,Huehuetenango,2782,1421,1361,20
Agosto,Quiché,2287,1157,1130,20
Agosto,Baja Verapaz,597,310,287,20
Agosto,Alta Verapaz,2709,1369,1340,20
Agosto,Petén,1265,649,616,20
Agosto,Izabal,884,419,465,20
Agosto,Zacapa,490,236,254,20
Agosto,Chiquimula,765,400,365,20
Agosto,Jalapa,722,370,352,20
Agosto,Jutiapa,839,431,408,20
Agosto,Extranjero,14,5,9,20
Agosto,Ignorado,4,2,2,20
Septiembre,Todos los departamentos,30825,15797,15028,20
Septiembre,Guatemala,4935,2501,2434,20
Septiembre,El Progreso,311,171,140,20
Septiembre,Sacatepéquez,556,279,277,20
Septiembre,Chimaltenango,1169,602,567,20
Septiembre,Escuintla,1271,666,605,20
Septiembre,Santa Rosa,655,343,312,20
Septiembre,Sololá,807,407,400,20
Septiembre,Totonicapán,1023,496,527,20
Septiembre,Quetzaltenango,1611,826,785,20
Septiembre,Suchitepéquez,1070,557,513,20
Septiembre,Retalhuleu,645,330,315,20
Septiembre,San Marcos,2245,1174,1071,20
Septiembre,Huehuetenango,3000,1549,1451,20
Septiembre,Quiché,2491,1254,1237,20
Septiembre,Baja Verapaz,651,332,319,20
Septiembre,Alta Verapaz,3068,1572,1496,20
Septiembre,Petén,1345,686,659,20
Septiembre,Izabal,895,464,431,20
Septiembre,Zacapa,501,256,245,20
Septiembre,Chiquimula,911,458,453,20
Septiembre,Jalapa,723,374,349,20
Septiembre,Jutiapa,902,481,421,20
Septiembre,Extranjero,30,14,16,20
Septiembre,Ignorado,10,5,5,20
Octubre,Todos los departamentos,29888,15044,14844,20
Octubre,Guatemala,4637,2352,2285,20
Octubre,El Progreso,336,181,155,20
Octubre,Sacatepéquez,532,278,254,20
Octubre,Chimaltenango,1201,619,582,20
Octubre,Escuintla,1283,641,642,20
Octubre,Santa Rosa,702,327,375,20
Octubre,Sololá,805,391,414,20
Octubre,Totonicapán,1009,510,499,20
Octubre,Quetzaltenango,1568,785,783,20
Octubre,Suchitepéquez,1043,537,506,20
Octubre,Retalhuleu,595,316,279,20
Octubre,San Marcos,2266,1168,1098,20
Octubre,Huehuetenango,2851,1428,1423,20
Octubre,Quiché,2406,1152,1254,20
Octubre,Baja Verapaz,642,321,321,20
Octubre,Alta Verapaz,2801,1428,1373,20
Octubre,Petén,1311,693,618,20
Octubre,Izabal,879,433,446,20
Octubre,Zacapa,481,241,240,20
Octubre,Chiquimula,813,412,401,20
Octubre,Jalapa,771,363,408,20
Octubre,Jutiapa,922,449,473,20
Octubre,Extranjero,19,11,8,20
Octubre,Ignorado,15,8,7,20
Noviembre,Todos los departamentos,27764,14065,13699,20
Noviembre,Guatemala,4297,2149,2148,20
Noviembre,El Progreso,308,158,150,20
Noviembre,Sacatepéquez,486,250,236,20
Noviembre,Chimaltenango,1150,593,557,20
Noviembre,Escuintla,1141,593,548,20
Noviembre,Santa Rosa,618,314,304,20
Noviembre,Sololá,785,413,372,20
Noviembre,Totonicapán,926,457,469,20
Noviembre,Quetzaltenango,1435,701,734,20
Noviembre,Suchitepéquez,979,476,503,20
Noviembre,Retalhuleu,629,333,296,20
Noviembre,San Marcos,2049,1051,998,20
Noviembre,Huehuetenango,2721,1379,1342,20
Noviembre,Quiché,2223,1104,1119,20
Noviembre,Baja Verapaz,600,310,290,20
Noviembre,Alta Verapaz,2713,1388,1325,20
Noviembre,Petén,1157,594,563,20
Noviembre,Izabal,783,394,389,20
Noviembre,Zacapa,406,214,192,20
Noviembre,Chiquimula,782,391,391,20
Noviembre,Jalapa,676,356,320,20
Noviembre,Jutiapa,867,434,433,20
Noviembre,Extranjero,24,10,14,20
Noviembre,Ignorado,9,3,6,20
Diciembre,Todos los departamentos,26076,13117,12959,20
Diciembre,Guatemala,4052,2086,1966,20
Diciembre,El Progreso,269,129,140,20
Diciembre,Sacatepéquez,444,234,210,20
Diciembre,Chimaltenango,1087,566,521,20
Diciembre,Escuintla,1003,506,497,20
Diciembre,Santa Rosa,570,300,270,20
Diciembre,Sololá,703,350,353,20
Diciembre,Totonicapán,898,463,435,20
Diciembre,Quetzaltenango,1331,622,709,20
Diciembre,Suchitepéquez,914,470,444,20
Diciembre,Retalhuleu,512,259,253,20
Diciembre,San Marcos,2010,1011,999,20
Diciembre,Huehuetenango,2672,1332,1340,20
Diciembre,Quiché,2206,1065,1141,20
Diciembre,Baja Verapaz,551,256,295,20
Diciembre,Alta Verapaz,2568,1281,1287,20
Diciembre,Petén,1041,518,523,20
Diciembre,Izabal,660,338,322,20
Diciembre,Zacapa,379,186,193,20
Diciembre,Chiquimula,761,392,369,20
Diciembre,Jalapa,655,346,309,20
Diciembre,Jutiapa,754,381,373,20
Diciembre,Extranjero,26,21,5,20
Diciembre,Ignorado,10,5,5,20
Todos los meses,Todos los departamentos,345149,174770,170379,21
Todos los meses,Guatemala,51191,25856,25335,21
Todos los meses,El Progreso,3405,1703,1702,21
Todos los meses,Sacatepéquez,5813,2982,2831,21
Todos los meses,Chimaltenango,14151,7134,7017,21
Todos los meses,Escuintla,14189,7115,7074,21
Todos los meses,Santa Rosa,7509,3796,3713,21
Todos los meses,Sololá,9602,4911,4691,21
Todos los meses,Totonicapán,12128,6228,5900,21
Todos los meses,Quetzaltenango,17875,9042,8833,21
Todos los meses,Suchitepéquez,12264,6220,6044,21
Todos los meses,Retalhuleu,6908,3514,3394,21
Todos los meses,San Marcos,26241,13330,12911,21
Todos los meses,Huehuetenango,35558,17914,17644,21
Todos los meses,Quiché,29303,14709,14594,21
Todos los meses,Baja Verapaz,7458,3782,3676,21
Todos los meses,Alta Verapaz,33326,16922,16404,21
Todos los meses,Petén,14095,7172,6923,21
Todos los meses,Izabal,9089,4658,4431,21
Todos los meses,Zacapa,5376,2729,2647,21
Todos los meses,Chiquimula,10388,5224,5164,21
Todos los meses,Jalapa,8707,4355,4352,21
Todos los meses,Jutiapa,10170,5270,4900,21
Todos los meses,Extranjero,328,168,160,21
Todos los meses,Ignorado,75,36,39,21
Enero,Todos los departamentos,26362,13453,12909,21
Enero,Guatemala,3848,1965,1883,21
Enero,El Progreso,244,124,120,21
Enero,Sacatepéquez,419,213,206,21
Enero,Chimaltenango,1057,544,513,21
Enero,Escuintla,1043,536,507,21
Enero,Santa Rosa,544,257,287,21
Enero,Sololá,740,374,366,21
Enero,Totonicapán,959,490,469,21
Enero,Quetzaltenango,1333,707,626,21
Enero,Suchitepéquez,840,422,418,21
Enero,Retalhuleu,493,261,232,21
Enero,San Marcos,2117,1111,1006,21
Enero,Huehuetenango,2841,1435,1406,21
Enero,Quiché,2320,1173,1147,21
Enero,Baja Verapaz,594,317,277,21
Enero,Alta Verapaz,2685,1358,1327,21
Enero,Petén,1001,496,505,21
Enero,Izabal,628,323,305,21
Enero,Zacapa,373,183,190,21
Enero,Chiquimula,866,417,449,21
Enero,Jalapa,621,313,308,21
Enero,Jutiapa,769,417,352,21
Enero,Extranjero,23,14,9,21
Enero,Ignorado,4,3,1,21
Febrero,Todos los departamentos,23828,11924,11904,21
Febrero,Guatemala,3419,1708,1711,21
Febrero,El Progreso,233,117,116,21
Febrero,Sacatepéquez,403,216,187,21
Febrero,Chimaltenango,958,470,488,21
Febrero,Escuintla,928,430,498,21
Febrero,Santa Rosa,483,227,256,21
Febrero,Sololá,666,322,344,21
Febrero,Totonicapán,859,447,412,21
Febrero,Quetzaltenango,1236,639,597,21
Febrero,Suchitepéquez,827,426,401,21
Febrero,Retalhuleu,430,221,209,21
Febrero,San Marcos,1874,892,982,21
Febrero,Huehuetenango,2598,1325,1273,21
Febrero,Quiché,2092,1071,1021,21
Febrero,Baja Verapaz,525,267,258,21
Febrero,Alta Verapaz,2318,1140,1178,21
Febrero,Petén,899,452,447,21
Febrero,Izabal,566,293,273,21
Febrero,Zacapa,388,185,203,21
Febrero,Chiquimula,770,392,378,21
Febrero,Jalapa,610,304,306,21
Febrero,Jutiapa,723,371,352,21
Febrero,Extranjero,19,8,11,21
Febrero,Ignorado,4,1,3,21
Marzo,Todos los departamentos,27474,13829,13645,21
Marzo,Guatemala,3896,1895,2001,21
Marzo,El Progreso,247,119,128,21
Marzo,Sacatepéquez,456,246,210,21
Marzo,Chimaltenango,1145,587,558,21
Marzo,Escuintla,1060,538,522,21
Marzo,Santa Rosa,592,305,287,21
Marzo,Sololá,789,424,365,21
Marzo,Totonicapán,1007,509,498,21
Marzo,Quetzaltenango,1419,721,698,21
Marzo,Suchitepéquez,984,512,472,21
Marzo,Retalhuleu,579,311,268,21
Marzo,San Marcos,2156,1065,1091,21
Marzo,Huehuetenango,2957,1467,1490,21
Marzo,Quiché,2457,1224,1233,21
Marzo,Baja Verapaz,595,309,286,21
Marzo,Alta Verapaz,2574,1285,1289,21
Marzo,Petén,1091,558,533,21
Marzo,Izabal,650,345,305,21
Marzo,Zacapa,442,214,228,21
Marzo,Chiquimula,864,435,429,21
Marzo,Jalapa,680,338,342,21
Marzo,Jutiapa,801,402,399,21
Marzo,Extranjero,26,16,10,21
Marzo,Ignorado,7,4,3,21
Abril,Todos los departamentos,27110,13667,13443,21
Abril,Guatemala,3954,2015,1939,21
Abril,El Progreso,226,115,111,21
Abril,Sacatepéquez,428,206,222,21
Abril,Chimaltenango,1128,569,559,21
Abril,Escuintla,1135,572,563,21
Abril,Santa Rosa,599,312,287,21
Abril,Sololá,782,411,371,21
Abril,Totonicapán,992,513,479,21
Abril,Quetzaltenango,1387,689,698,21
Abril,Suchitepéquez,986,506,480,21
Abril,Retalhuleu,543,269,274,21
Abril,San Marcos,2066,1045,1021,21
Abril,Huehuetenango,2745,1358,1387,21
Abril,Quiché,2353,1156,1197,21
Abril,Baja Verapaz,575,281,294,21
Abril,Alta Verapaz,2691,1366,1325,21
Abril,Petén,1088,563,525,21
Abril,Izabal,741,364,377,21
Abril,Zacapa,426,220,206,21
Abril,Chiquimula,771,374,397,21
Abril,Jalapa,687,328,359,21
Abril,Jutiapa,785,425,360,21
Abril,Extranjero,17,8,9,21
Abril,Ignorado,5,2,3,21
Mayo,Todos los departamentos,28732,14741,13991,21
Mayo,Guatemala,4388,2220,2168,21
Mayo,El Progreso,269,144,125,21
Mayo,Sacatepéquez,496,250,246,21
Mayo,Chimaltenango,1136,576,560,21
Mayo,Escuintla,1187,621,566,21
Mayo,Santa Rosa,637,318,319,21
Mayo,Sololá,803,398,405,21
Mayo,Totonicapán,992,532,460,21
Mayo,Quetzaltenango,1469,743,726,21
Mayo,Suchitepéquez,1016,512,504,21
Mayo,Retalhuleu,634,325,309,21
Mayo,San Marcos,2209,1141,1068,21
Mayo,Huehuetenango,3038,1545,1493,21
Mayo,Quiché,2479,1258,1221,21
Mayo,Baja Verapaz,630,329,301,21
Mayo,Alta Verapaz,2734,1400,1334,21
Mayo,Petén,1106,569,537,21
Mayo,Izabal,715,381,334,21
Mayo,Zacapa,417,212,205,21
Mayo,Chiquimula,818,444,374,21
Mayo,Jalapa,700,365,335,21
Mayo,Jutiapa,820,430,390,21
Mayo,Extranjero,35,26,9,21
Mayo,Ignorado,4,2,2,21
Junio,Todos los departamentos,28302,14088,14214,21
Junio,Guatemala,4249,2093,2156,21
Junio,El Progreso,285,144,141,21
Junio,Sacatepéquez,487,237,250,21
Junio,Chimaltenango,1113,544,569,21
Junio,Escuintla,1212,590,622,21
Junio,Santa Rosa,600,289,311,21
Junio,Sololá,737,358,379,21
Junio,Totonicapán,989,500,489,21
Junio,Quetzaltenango,1454,705,749,21
Junio,Suchitepéquez,1046,522,524,21
Junio,Retalhuleu,606,279,327,21
Junio,San Marcos,2230,1114,1116,21
Junio,Huehuetenango,2901,1457,1444,21
Junio,Quiché,2504,1264,1240,21
Junio,Baja Verapaz,642,326,316,21
Junio,Alta Verapaz,2599,1339,1260,21
Junio,Petén,1095,527,568,21
Junio,Izabal,730,386,344,21
Junio,Zacapa,415,214,201,21
Junio,Chiquimula,864,409,455,21
Junio,Jalapa,717,373,344,21
Junio,Jutiapa,796,409,387,21
Junio,Extranjero,26,8,18,21
Junio,Ignorado,5,1,4,21
Julio,Todos los departamentos,30089,15230,14859,21
Julio,Guatemala,4389,2252,2137,21
Julio,El Progreso,298,136,162,21
Julio,Sacatepéquez,508,259,249,21
Julio,Chimaltenango,1298,657,641,21
Julio,Escuintla,1222,614,608,21
Julio,Santa Rosa,680,342,338,21
Julio,Sololá,853,443,410,21
Julio,Totonicapán,1066,530,536,21
Julio,Quetzaltenango,1483,765,718,21
Julio,Suchitepéquez,1107,571,536,21
Julio,Retalhuleu,562,285,277,21
Julio,San Marcos,2284,1136,1148,21
Julio,Huehuetenango,3136,1562,1574,21
Julio,Quiché,2529,1301,1228,21
Julio,Baja Verapaz,677,355,322,21
Julio,Alta Verapaz,2941,1451,1490,21
Julio,Petén,1271,662,609,21
Julio,Izabal,758,395,363,21
Julio,Zacapa,447,229,218,21
Julio,Chiquimula,902,458,444,21
Julio,Jalapa,748,364,384,21
Julio,Jutiapa,891,441,450,21
Julio,Extranjero,33,19,14,21
Julio,Ignorado,6,3,3,21
Agosto,Todos los departamentos,30886,15770,15116,21
Agosto,Guatemala,4693,2377,2316,21
Agosto,El Progreso,324,165,159,21
Agosto,Sacatepéquez,552,300,252,21
Agosto,Chimaltenango,1256,652,604,21
Agosto,Escuintla,1361,686,675,21
Agosto,Santa Rosa,715,380,335,21
Agosto,Sololá,844,430,414,21
Agosto,Totonicapán,1089,583,506,21
Agosto,Quetzaltenango,1570,807,763,21
Agosto,Suchitepéquez,1079,520,559,21
Agosto,Retalhuleu,660,349,311,21
Agosto,San Marcos,2227,1155,1072,21
Agosto,Huehuetenango,3198,1602,1596,21
Agosto,Quiché,2535,1269,1266,21
Agosto,Baja Verapaz,641,339,302,21
Agosto,Alta Verapaz,2957,1499,1458,21
Agosto,Petén,1321,692,629,21
Agosto,Izabal,889,476,413,21
Agosto,Zacapa,475,229,246,21
Agosto,Chiquimula,894,439,455,21
Agosto,Jalapa,699,355,344,21
Agosto,Jutiapa,874,449,425,21
Agosto,Extranjero,24,12,12,21
Agosto,Ignorado,9,5,4,21
Septiembre,Todos los departamentos,32497,16537,15960,21
Septiembre,Guatemala,4852,2475,2377,21
Septiembre,El Progreso,352,180,172,21
Septiembre,Sacatepéquez,532,266,266,21
Septiembre,Chimaltenango,1314,646,668,21
Septiembre,Escuintla,1307,663,644,21
Septiembre,Santa Rosa,672,329,343,21
Septiembre,Sololá,882,470,412,21
Septiembre,Totonicapán,1103,600,503,21
Septiembre,Quetzaltenango,1756,884,872,21
Septiembre,Suchitepéquez,1169,624,545,21
Septiembre,Retalhuleu,638,318,320,21
Septiembre,San Marcos,2364,1226,1138,21
Septiembre,Huehuetenango,3232,1643,1589,21
Septiembre,Quiché,2678,1330,1348,21
Septiembre,Baja Verapaz,667,308,359,21
Septiembre,Alta Verapaz,3198,1621,1577,21
Septiembre,Petén,1408,712,696,21
Septiembre,Izabal,949,476,473,21
Septiembre,Zacapa,549,287,262,21
Septiembre,Chiquimula,986,505,481,21
Septiembre,Jalapa,859,436,423,21
Septiembre,Jutiapa,997,526,471,21
Septiembre,Extranjero,26,11,15,21
Septiembre,Ignorado,7,1,6,21
Octubre,Todos los departamentos,30863,15505,15358,21
Octubre,Guatemala,4520,2303,2217,21
Octubre,El Progreso,329,154,175,21
Octubre,Sacatepéquez,504,251,253,21
Octubre,Chimaltenango,1273,630,643,21
Octubre,Escuintla,1246,618,628,21
Octubre,Santa Rosa,676,336,340,21
Octubre,Sololá,870,431,439,21
Octubre,Totonicapán,1052,513,539,21
Octubre,Quetzaltenango,1626,782,844,21
Octubre,Suchitepéquez,1129,555,574,21
Octubre,Retalhuleu,597,313,284,21
Octubre,San Marcos,2281,1176,1105,21
Octubre,Huehuetenango,3058,1550,1508,21
Octubre,Quiché,2473,1242,1231,21
Octubre,Baja Verapaz,678,311,367,21
Octubre,Alta Verapaz,2966,1530,1436,21
Octubre,Petén,1412,720,692,21
Octubre,Izabal,900,455,445,21
Octubre,Zacapa,529,271,258,21
Octubre,Chiquimula,934,460,474,21
Octubre,Jalapa,838,411,427,21
Octubre,Jutiapa,939,475,464,21
Octubre,Extranjero,29,15,14,21
Octubre,Ignorado,4,3,1,21
Noviembre,Todos los departamentos,29554,15080,14474,21
Noviembre,Guatemala,4488,2260,2228,21
Noviembre,El Progreso,294,141,153,21
Noviembre,Sacatepéquez,540,287,253,21
Noviembre,Chimaltenango,1211,616,595,21
Noviembre,Escuintla,1229,630,599,21
Noviembre,Santa Rosa,669,358,311,21
Noviembre,Sololá,824,432,392,21
Noviembre,Totonicapán,978,486,492,21
Noviembre,Quetzaltenango,1589,814,775,21
Noviembre,Suchitepéquez,1015,515,500,21
Noviembre,Retalhuleu,589,299,290,21
Noviembre,San Marcos,2242,1165,1077,21
Noviembre,Huehuetenango,2994,1521,1473,21
Noviembre,Quiché,2472,1243,1229,21
Noviembre,Baja Verapaz,607,326,281,21
Noviembre,Alta Verapaz,2775,1432,1343,21
Noviembre,Petén,1232,625,607,21
Noviembre,Izabal,803,390,413,21
Noviembre,Zacapa,455,255,200,21
Noviembre,Chiquimula,874,457,417,21
Noviembre,Jalapa,752,358,394,21
Noviembre,Jutiapa,874,450,424,21
Noviembre,Extranjero,36,15,21,21
Noviembre,Ignorado,12,5,7,21
Diciembre,Todos los departamentos,29452,14946,14506,21
Diciembre,Guatemala,4495,2293,2202,21
Diciembre,El Progreso,304,164,140,21
Diciembre,Sacatepéquez,488,251,237,21
Diciembre,Chimaltenango,1262,643,619,21
Diciembre,Escuintla,1259,617,642,21
Diciembre,Santa Rosa,642,343,299,21
Diciembre,Sololá,812,418,394,21
Diciembre,Totonicapán,1042,525,517,21
Diciembre,Quetzaltenango,1553,786,767,21
Diciembre,Suchitepéquez,1066,535,531,21
Diciembre,Retalhuleu,577,284,293,21
Diciembre,San Marcos,2191,1104,1087,21
Diciembre,Huehuetenango,2860,1449,1411,21
Diciembre,Quiché,2411,1178,1233,21
Diciembre,Baja Verapaz,627,314,313,21
Diciembre,Alta Verapaz,2888,1501,1387,21
Diciembre,Petén,1171,596,575,21
Diciembre,Izabal,760,374,386,21
Diciembre,Zacapa,460,230,230,21
Diciembre,Chiquimula,845,434,411,21
Diciembre,Jalapa,796,410,386,21
Diciembre,Jutiapa,901,475,426,21
Diciembre,Extranjero,34,16,18,21
Diciembre,Ignorado,8,6,2,21
